https://en.wikipedia.org/wiki/List_of_railway_stations_in_India
Abada 	ABB 	West Bengal 	SER/South Eastern 	7 m 	[1]
Argora 	AOR 	Jharkhand 	SER/South Eastern 	654 m 	[2]
Abhaipur 	AHA 	Bihar 	ER/Eastern 	44 m 	[3]
A N Dev Nagar 	ACND 	Punjab 	Not Known 	Not Known 	
Abhayapuri 	AYU 	Assam 	NFR/Northeast Frontier 	45 m 	[4]
Abohar 	ABS 	Punjab 	NR/Northern 	186 m 	[5]
Abu Road 	ABR 	Rajasthan 	NWR/North Western 	260 m 	[6]
Acharapakkam 	ACK 	Tamil Nadu 	SR/Southern 	39 m 	[7]
Achalganj 	ACH 	Uttar Pradesh 	NR/Northern 	133 m 	[8]
Achalpur 	ELP 	Maharashtra 	CR/Central 	388 m 	[9]
Achhalda 	ULD 	Uttar Pradesh 	NCR/North Central 	147 m 	[10]
Achhnera Junction 	AH 	Uttar Pradesh 	NCR/North Central 	170 m 	
Adarshnagar 	AHO 	Rajasthan 			
Adarshnagar Delhi 	ANDI 	Delhi 	
Adas Road 	ADD 	Maharashtra 		44 m 	
Adesar 	AAR 	Gujarat 		30 m 	
Adgaon Buzurg 	ABZ 	Maharashtra 	SCR 		
Adilabad 	ADB 	Telangana 		248 m 	
Adipur 	AI 	Gujarat 		36 m 	
Adityapur 	ADTP 	Jharkhand 		153 m 	
Adoni 	AD 	Andhra Pradesh 		420 m 	
Adra Junction 	ADRA 	West Bengal 	ER/Eastern Railway 	190 m 	
Aduturai 	da 	Tamil Nadu 		24 m 	
Agartala 	AGTL 	Tripura 	NFR/North Frontier Railway 	27 m 	
Agas 	AGAS 	Gujarat 		42 m 	
Agasod 	AGD 	Madhya Pradesh 		427 m 	
Ataria 	AA 	Uttar Pradesh 			
Amb Andaura 	AADR 	Himachal Pradesh 			
Angar 	AAG 	Maharastra 			
Angadippuram 	AAM 	Kerala 			
Ambiapur 	AAP 	Uttar Pradesh 			
Ambikeshwar 	ABE 	Madhya Pradesh 			
Arabagatta H 	ABGT 	Karnataka 			
Ambale 	ABLE 	Maharastra 			
Asthal Bohar Junction 	ABO 	Haryana 			
Ambattur 	ABU 	Tamil Nadu 			
Abutara Halt 	ABW 	West Bengal 	ER/Eastern Railway 		
Ambari 	ABX 	Maharastra 			
Ambarnath 	A 	Maharashtra 	CR/Central
Ambivli 	ABY 	Maharastra 	CR/Central 		
Aghwanpur 	AWP 	Uttar Pradesh 			
Agomoni 	AGMN 	Assam 	NFR/Northeast Frontier 	31 m 	[11]
Agori Khas 	AGY 	Uttar Pradesh 		210 m 	
Agra Cantonment 	AGC 	Uttar Pradesh 		174 m 	
Agra City 	AGA 	Uttar Pradesh 		165 m 	
Agra Fort 	AF 	Uttar Pradesh 		170 m 	
Ahalyapur 	AHLR 	Uttar Pradesh 			
Ahmadgarh 	AHH 	Punjab 		252 m 	
Ahmednagar 	ANG 	Maharashtra 	CR/ 	650 m 	
Ahmedpur Junction 	AMP 	West Bengal 	ER/Eastern Railway 	46 m 	
Ahmedabad Junction 	ADI 	Gujarat 		52 m 	
Ahraura Road 	ARW 	Uttar Pradesh 		85 m 	
Airoli 		Maharashtra 	Trans-Harbour (CR)
Aishbagh 	ASH 	Uttar Pradesh 		122 m 	
Ait 	AIT 	Uttar Pradesh 		154 m 	
Aithal 	ATMO 	Uttarakhand 		245 m 	
Ajaibpur 	AJR 	Uttar Pradesh 		206 m 	
Ajanti 	ANI 	Madhya Pradesh 		338 m 	
Ajaraka 	AIA 	Rajasthan 		280 m 	
Ajgain 	AJ 	Uttar Pradesh 		128 m 	
Ajhai 	AJH 	Uttar Pradesh 		184 m 	
Ajit 	AJIT 	Rajasthan 		150 m 	
Ajmer Junction 	AII 	Rajasthan 		464 m 	
Ajni 	AJNI 	Maharashtra 	CR 	310 m 	
Akalkot Road 	AKOR 	Maharashtra 		457 m 	
Akaltara 	AKT 	Chhattisgarh 		284 m 	
Akanapet 	AKE 	Andhra Pradesh 		566 m 	
Akbarganj 	AKJ 	Uttar Pradesh 			
Akbarpur 	ABP 	Uttar Pradesh 		95 m 	
Akividu 	AKVD 	Andhra Pradesh 		5 m 	
Akodia 	AKD 	Madhya Pradesh 		460 m 	
Akola Junction 	AK 	Maharashtra 	CR/Central 	285 m 	
Akolner 	AKR 	Maharashtra 			
Akora 	AKW 	Rajasthan 			
Akot 	AKOT 	Maharashtra 			
Akurdi 	AKRD 	Maharashtra 	CR 		
Alamnagar 	AMG 	Bihar 			
Aler 	ALER 	Telangana 	SCR 		
Algapur 	ALGP 	Assam 	NFR/Northeast Frontier 	25 m 	[12]
Algawan 	AIG 	Uttar Pradesh 			
Alia Bada 	ALB 	Odisha 			
Aligarh Junction 	ALJN 	Uttar Pradesh 			
Alipurduar 	APD 	West Bengal 			
Alipurduar Junction 	APDJ 	West Bengal 	NFR/Northeast Frontier Railway 		
Allahabad City 	ALY 	Uttar Pradesh 			
Allahabad Junction 	ALD 	Uttar Pradesh 			
Alappuzha 	ALLP 	Kerala 			
Almatti 	LMT 	Karnataka 			
Alnavar Junction 	LWR 	Karnataka 			
Alniya 	ALNI 	Rajasthan 			
Aluabari Road 	AUB 	West Bengal 	NFR/Northeast Frontier Railway 		
Alwar 	AWR 	Rajasthan 			
Aluva 	AWY 	Kerala 			
Amalner 	AN 	Maharashtra 			
Amalsad 	AML 	Gujarat 			
Aman Vadi 	AMW 	Maharastra 			
Amarpura 	APA 	Rajasthan 			
Amausi 	AMS 	Uttar Pradesh 			
Ambagaon 	AGB 	Odisha 			
Ambala Cantonment 	UMB 	Haryana 	NR/Northern 		
Ambala City 	UBC 	Haryana 			
Ambalappuzha 	AMPA 	Kerala 			
Ambari Falakata 	ABFC 	West Bengal 	ER/Eastern Railway 		
Ambarnath 	ABH 	Maharashtra 			
Ambassa 	ABSA 	Tripura 	NFR/Northeast Frontier 		
Ambasamudram 	ASD 	Tamil Nadu 			
Ambattur 	ABU 	Tamil Nadu 	SR/Southern 	19.18 m 	
Ambaturai 	ABI 	Tamil Nadu 	SR/Southern 		
Ambika Kalna 	ABKA 	West Bengal 			
Ambikapur 	ABKP 	Chhattisgarh 	SECR/South East Central 		
Ambli Road 	ABD 	Gujarat 			
Ambliyasan 	UMN 	Gujarat 			
Ambodala 	AMB 	Odisha 	ECoR/East Coast 		
Ambur 	AB 	Tamil Nadu 			
Amethi 	AME 	Uttar Pradesh 	NR/Northern 		
Amgaon 	AGN 	Maharashtra 			
Amguri 	AGI 	Assam 	NFR/Northeast Frontier 	104m 	[13]
Amla Junction 	AMLA 	Madhya Pradesh 	CR/Central 		
Amlai 	AAL 	Madhya Pradesh 	SECR 		
Amlakhurd 	AMX 	Madhya Pradesh 			
Amli 	AMLI 	Dadra & Nagar Haveli 			
Ammasandra 	AMSA 	Karnataka 			
Amoni 	AONI 	Assam 	NFR/Northeast Frontier 	72 m 	[14]
Amravati 	AMI 	Maharashtra 	CR 		
Amreli 	AE 	Gujarat 			
Amritsar Junction 	ASR 	Punjab 	NR 		
Amritvel 	AVL 	Gujarat 			
Amroha 	AMRO 	Uttar Pradesh 			
Anakapalle 	AKiP 	Andhra Pradesh 	SCR 		
Anand Junction 	ANND 	Gujarat 			
Anand Nagar 	ANDN 	Andhra Pradesh 			
Anand Vihar 	ANVR 	Delhi 	NR 		
Anandpur Sahib 	ANSB 	Punjab 	NR 		
Anandtandavpur 	ANP 	Tamil Nadu 			
Anantapur 	ATP 	Andhra Pradesh 	SCR 		
Anaparti 	APT 	Andhra Pradesh 	SCR 		
Anara 	ANR 	West Bengal 	ER/Eastern Railway 		
Anas 	ANAS 	Madhya Pradesh 			
Andal Junction 	UDL 	West Bengal 	ER/Eastern Railway 		
Andheri 	ADH 	Maharashtra 	WR/Western/Harbour (CR) 		
Angamaly 	AFK 	Kerala 	SR 		
Angul 	ANGL 	Odisha 	ECoR/East Coastal Railway 		
Anipur 	APU 	Assam 	NFR/Northeast Frontier 	40 m 	[15]
Anjangaon 	ANJ 	Maharashtra 	CR/Central 	347 m 	[9]
Anjani 	ANO 	Maharastra 			
Anjar 	AJE 	Gujarat 			
Anjhi Shahabad 	AJI 	Uttar Pradesh 			
Ankai 	ANK 	Maharashtra 	SCR 		
Ankleshwar Junction 	AKV 	Gujarat 	WR 		
Ankola 	ANKL 	Karnataka 			
Annanur 	ANNR 	Tamil Nadu 	SR/Southern 	24.28 m 	
Annavaram 	ANV 	Andhra Pradesh 	SCR 		
Annigeri 	NGR 	Karnataka 			
Anpara 	ANPR 	Uttar Pradesh 			
Antah 	ATH 	Rajastan 			
Antu 	ANTU 	Uttar Pradesh 			
Anugraha Narayan Road 	AUBR 	Bihar 	ECR 		
Anupgarh 	APH 	Rajasthan 	WR/Western Railway 		
Anuppur Junction 	APR 	Madhya Pradesh 	SECR 		
Anupshahr 	AUS 	Uttar Pradesh 			
Aonla 	AO 	Uttar Pradesh 			
Ara 	ARA 	Bihar 	ECR/East Central Railway 		
Arakkonam Junction 	AJJ 	Tamil Nadu 	SR/Southern railway 	
Araku 	ARK 	Andhra Pradesh 	ECoR 		
Aralvaymozhi 	AAY 	Tamil Nadu 			
Arariya 	ARR 	Bihar 			
Arariya Court 	ARQ 	Bihar 			
Arasur 	ARS 	Tamil Nadu 			
Aravalli Road 	AVRD 	Karnataka 			
Arunachal 	ARCL 	Assam 	NFR/Northeast Frontier 	22 m 	[16]
Aravankadu 	AVK 	Tamil Nadu 			
Ariyalur 	ALU 	Tamil Nadu 			
Arjansar 	AS 	Rajasthan 			
Arnetha 	ARE 	Rajasthan 			
Arni Road 	ARV 	Tamil Nadu 			
Arsikere Junction 	ASK 	Karnataka 			
Aruppukottai 	APK 	Tamil Nadu 	Southern railway 	450 m 	
Arvi 	ARVI 	Maharashtra 	CR/Central 		
Aryankavu 	AYV 	Kerala 			
Asafpur 	AFR 	Uttar Pradesh 			
Asalpur Jobner 	JOB 	Rajasthan 			
Asangaon 	AN 	Maharashtra 	CR/Central 		
Asansol Junction 	ASN 	West Bengal 	ER/Eastern Railway 		
Asaoti 	AST 	Haryana 			
Ashok Nagar 	ASKN 	Madhya Pradesh 			
Aslana 	ANA 	Madhya Pradesh 			
Aslaoda 	ASL 	Madhya Pradesh 			
Asnoti 	AT 	Karnataka 			
Asokhar 	AXK 	Madhya Pradesh 			
Asranada 	AAS 	Rajasthan 			
Atari 	ATT 	Punjab 			
Atarra 	ATE 	Uttar Pradesh 			
Ateli 	AEL 	Haryana 			
Atgaon 	ATG 	Maharashtra 	CR/Central
Athipattu 	AIP 	Tamil Nadu 	SR/Southern 		
Athipattu Pudhunagar 	AIPP 	Tamil Nadu 	SR/Southern 	4 m 	
Atrampur 	ARP 	Uttar Pradesh 			
Atrauli Road 	AUR 	Uttar Pradesh 			
Atru 	ATRU 	Rajasthan 			
Attabira 	ATS 	Odisha 			
Attar 	ATR 	Madhya Pradesh 			
Attur 	ATTR 	Tamil Nadu 			
Aujari 	AJRE 	Assam 	NFR/Northeast Frontier 	60 m 	[17]
Aulenda 	AED 	Uttar Pradesh 			
Aunrihar Junction 	ARJ 	Uttar Pradesh 			
Aurangabad 	AWB 	Maharashtra 	SCR/South Central 		
Auvaneswarem 	AVS 	Kerala 			
Auwa 	AUWA 	Rajastan 			
Avadi 	AVD 	Tamil Nadu 	SR/Southern 	26.85 m 	
Ayodhya 	AY 	Uttar Pradesh 			
Azamgarh 	AMH 	Uttar Pradesh 			
Azamnagar Road 	AZR 	Bihar 			
Azara 	AZA 	Assam 	NFR/Northeast Frontier 	51 m 	[18]
Azimganj City 	ACLE 	West Bengal 	ER/Eastrn Railway 		
Azimganj Junction 	AZ 	West Bengal 	ER/Eastrn Railway 		
B
Main entrance of Bareilly Junction.
Station Name 	Station Code 	State 	Railway Zone 	Elevation 	Map
Babarpur 	BBDE 	Haryana 		
Babatpur 	BTP 	Uttar Pradesh 		
Bebejia 	BEE 	Assam 	
Babhnan 	BV 	Uttar Pradesh 		
Babina 	BAB 	Madhya Pradesh 		
Babrala 	BBA 	Uttar Pradesh 		
Babugarh 	BBO 	Uttar Pradesh 		
Babupeth 	BUPH 	Maharastra 		
Bacheli 	BCHL 	Chhattisgarh 		
Bachhrawan 	BCN 	Uttar Pradesh 		
Bachwara Junction 	BCA 	Bihar 		
Badmal 	BUDM 	Odisha 	
Baad 	BAD 	Uttar Pradesh 		
Badagara (Vatakara) 	BDJ 	Kerala 		
Badami 	BDM 	Karnataka 		
Badampahar 	BMPR 	Jharkhand 		
Badampudi 	BPY 	Andhra Pradesh 		
Badurpur Ghat 	BPG 	Assam 	NFR/Northeast Frontier 	27 m 	[19]
Badarpur Junction 	BPB 	Assam 	NFR/Northeast Frontier 	23 m 	[20]
Badausa 	train 	Uttar Pradesh 		
Badgam 	BDGM 	Jammu & Kashmir 	1668m 	
Badhada 	BDHA 	Gujarat 		
Badhal 	BDHL 	Rajasthan 		
Badlapur 	BUD 	Maharashtra 	CR/Central 	
Badli 	BHD 	Delhi 		
Badnapur 	BDU 	Maharashtra 		
Badnera Junction 	BD 	Maharashtra 		
Badshahnagar 	BNZ 	Uttar Pradesh 		
Badshahpur 	BSE 	Haryana 		
Badwasi 	BWS 	Rajasthan 		
Bagaha 	BUG 	Bihar 		
Bagalkot 	BGK 	Karnataka 		
Bagbahra 	BGBR 	Chhattisgarh 		
Bagetar 	BF 	Assam 	NFR/Northeast Frontier 	515 m 	[21]
Bagevadi Rd 	BSRX 	Karnataka 		
Baghauli 	BGH 	Uttar Pradesh 		
Baghora 	BJQ 	Madhya Pradesh 		
Bagra Tawa 	BGTA 	Madhya Pradesh 		
Bagri Nagar 	BQN 			
Bagri Sajjanpur 	BGX 			
Bagwali 	BWB 			
Bahadur Singh W 	BSS 			
Bahadurgarh 	BGZ 	Haryana 		
Bahadurpur 	BPD 			
Baheri 	BHI 			
Bahilpurwa 	BIP 			
Bahjoi 	BJ 			
Bahraich 	BRK 	Uttar Pradesh 		
Baidyanathdham 	BDME 	Jharkhand 		
Baihata Chariali 	BIZ 	Assam 	NFR/Northeast Frontier 	55 m 	[22]
Baiguda 	BGUA 	Odisha 	
Baijnathpur 	BYP 			
Baikunthpur Rd 	BRH 	Chhattisgarh 		
Bainchi 	BOI 	West Bengal 	ER/Eastrn Railway 	
Bairabi (Bhairabi) 	BHRB 	Mizoram 	NFR/Northeast Frontier 	48 m 	[23]
Bairapur 	BIP 	Madhya Pradesh 		
Bairagnia 	BGU 			
Baitalpur 	BALR 			
Bajva 	BJW 			
Bakhtiyarpur Junction 	BKP 	Bihar 		
Bakra Road 	BK 	Rajasthan 		
Balaghat 	BTC 	Madhya Pradesh 		
Balamau Junction 	BLM 	Uttar Pradesh 		
Balangir 	BLGR 	Odisha 		
Balasore 	BLS 	Odisha 		
Balauda Takun 	BLDK 			
Balawala 	BLWL 			
Balawali 	BLW 			
Balharshah 	BPQ 	Maharashtra 		
Baliakheri 	BAE 			
Balikotia 	BKS 	Assam 	NFR/Northeast Frontier 	67 m 	[24]
Balipara 	BVU 	Assam 		
Ballabhgarh 	BVH 	Haryana 		
Balli 	BLLI 			
Ballia 	BUI 	Uttar Pradesh 		
Ballupur 	BAPR 	Uttar Pradesh 		
Bally 	BLY 	West Bengal 	ER/Eastrn Railway 	
Balrampur 	BLP 	Madhya Pradesh 		
Balsamand 	BLSD 			
Balugan 	BALU 	Odisha 		
Balwa 	WAB 			
Balwara 	BAWA 	Rajasthan 		
Bamangachhi 	BMG 	West Bengal 	ER/Eastrn Railway 	
Bamanheri 	BMHR 			
Bamhani 	BMW 			
Bamla 	BMLL 	Haryana 		
Bamnia 	BMI 			
Bamsin 	BMSN 	Rajasthan 		
Bamra 	BMB 	Odisha 		
Bamsin 	BMSN 			
Bamuni Gaon 	BGMN 	Assam 	NFR/Northeast Frontier 	48 m 	[25]
Banahi 	BYN 			
Banapura 	BPF 	Madhya Pradesh 		
Banar 	BNO 	Rajasthan 		
Banarhat 	BNQ 	West Bengal 	ER/Eastrn Railway 	
Banas 	BNS 	Rajasthan 		
Banasandra 	BSN 	Karnataka 		
Banbasa 	BNSA 			
Banda Junction 	BNDA 	Uttar Pradesh 		
Bandakpur 	BNU 			
Bandanwara 	BDW 	Rajasthan 		
Bandarkhal 	BXK 	Assam 	NFR/Northeast Frontier 	104 m 	[26]
Bandel Junction 	BDC 	West Bengal 	ER/Eastrn Railway 	
Bandh Bareta 	BR 			
Bandikui Junction 	BKI 	Rajasthan 		
Bandra 	BA 	Maharashtra 	WR/Western/Harbour (CR)
Bandra Terminus 	BDTS 	Maharashtra 	WR/Western 	
Bangalore Cantonment 	BNC 	Karnataka 		
Bangalore City Junction 	SBC 	Karnataka 		
Bangalore East 	BNCE 	Karnataka 		
Bangarapet 	BWT 	Karnataka 		
Bangarapet 	BWY 	Karnataka 		
Bangrod 	BOD 			
Bani 	BANI 			
Baniya Sanda DH 	BSDA 			
Bankata 	BTK 			
Bankura 	BQA 	West Bengal 	ER/Eastrn Railway 	
Bankura 	BQK 	West Bengal 	ER/Eastrn Railway 	
Banmankhi Junction 	BNKI 	Bihar 		
Banmor 	BAO 			
Bansdih Road 	BCD 			
Banshlai Bridge 	BSBR 			
Bansi Paharpur 	BIQ 			
Bansipur 	BSQP 			
Banasthali Niwai 	BNLW 	Rajasthan 		
Banta Raghunathgarh 	BGG 			
Bantawala 	BNTL 	Karnataka 		
Banthra 	BTRA 			
Banwali 	BWC 			
Baori Thikria 	BOTI 			
Bapatla 	BPP 	Andhra Pradesh 		
Bar 	BAR 			
Bara Jamda 	BJMD 	Jharkhand 		
Barabanki Junction 	BBK 	Uttar Pradesh 	
Barabhum 	BBM 	West Bengal 	ER/Eastrn Railway 	
Barbil 	BBN 	Odisha 		
Baradwar 	BUA 			
Baragaon 	BNM 			
Barahu 	BRHU 	Assam 	NFR/Northeast Frontier 	58 m 	[27]
Baraigram Junction 	BRGM 	Assam 	NFR/Northeast Frontier 	24 m 	[28]
Barakar 	BRR 	West Bengal 	ER/Eastrn Railway 	
Baral 	BARL 			
Baramati 	BRMT 	Maharashtra 		
Baran 	BAZ 	Rajasthan 		
Baranagar 	BARN 	West Bengal 	ER/Eastrn Railway 	
Barara 	RAA 	Haryana 		
Barasat Junction 	BT 	West Bengal 	ER/Eastrn Railway 	
Barauni Junction 	BJU 	Bihar 		
Barbatpur 	BBTR 			
Barchi Road 	BCRD 			
Barddhaman Junction 	BWN 	West Bengal 	ER/Eastrn Railway 	
Bardoli 	BIY 	Gujarat 		
Bareilly 	BE 	Uttar Pradesh 		
Barelly 	BRY 	Madhya Pradesh 		
Barejadi 	BJD 			
Bareta 	BRZ 			
Bareth 	BET 			
Bargarh Road 	BRGA 	Odisha 		
Bargawan 	BRGW 			
Barh 	BARH 	Bihar 		
Barhan 	BRN 			
Barharwa Junction 	BHW 	Jharkhand 	ECR/East Central Railway 	
Barhiya 	BRYA 	Bihar 		
Barhni 	BNY 	Uttar Pradesh 		
Bari Brahman 	BBMN 	Jammu & Kashmir 		
Bariarpur 	BUP 	Bihar 		
Barkakana 	BRKA 	Jharkhand 		
Barkur 	BKJ 	Karnataka 	KRCL 	
Barlai 	BLAX 			
Barmer 	BME 	Rajasthan 		
Barnagar 	BNG 	West Bengal 	ER/Eastrn Railway 	
Barnala 	BNN 	Punjab 		
Barog 	BOF 	Himachal Pradesh 		
Barpali 	BRPL 	Odisha 		
Barpeta Road 	BPRD 	Assam 	NFR/Northeast Frontier 	51 m 	[29]
Barrackpore 	BP 	West Bengal 	ER/Eastrn Railway 	
Barsathi 	BSY 			
Barsi Takli 	BSQ 	Maharashtra 		
Barsi Town 	BTW 	Maharashtra 		
Barsoi Junction 	BOE 	Bihar 		
Barsola 	BZO 			
Barsuan 	BXF 	Odisha 		
Baruva 	BAV 			
Barwa Sagar 	BWR 			
Barwadih Junction 	BRWD 	Jharkhand 		
Barwaha 	BWW 			
Barya Ram 	BYHA 			
Basai 	BZY 			
Basar 	BSX 	Telangana 		
Basbari 	BSI 	Assam 	NFR/Northeast Frontier 	47 m 	[30]
Basharatganj 	BTG 			
Basi Kiratpur 	BSKR 			
Basin Bridge 	BBQ 	Tamil Nadu 	SR/Southern 	7 m 	
Basmat 	BMF 	Maharashtra 		
Basni 	BANE 	Rajasthan 		
Bassi Pathana 	BSPN 	Punjab 		
Basta 	BTS 	Odisha 	SER/South Eastern Railway 	
Basti 	BST 	Uttar Pradesh 		
Basugaon 	BSGN 	Assam 	NFR/Northeast Frontier 	53 m 	[31]
Baswa 	BU 			
Batadrowa Road 	BTDR 	Assam 	NFR/Northeast Frontier 	69 m 	[32]
Batala Junction 	BAT 	Punjab 		
Bauria Junction 	BVA 	West Bengal 	SER/South Eastrn Railway 	
Bavla 	VLA 			
Bawal 	BWL 	Haryana 		
Bawani Khera 	BWK 	Haryana 		
Bayana Junction 	BXN 	Rajasthan 		
Baytu 	BUT 			
Bazida Jatan 	BZJT 	Haryana 		
Bazpur 	BPZ 	Uttarakhand 		
Bazurghat 	BZGT 	Assam 	NFR/Northeast Frontier 	37 m 	[33]
Beas 	BEAS 	Punjab 		
Beawar 	BER 	Rajasthan 		
Begunkodor 		West BengalER/Eastrn Railway 	
Bedetti 	BVV 			
Begampet 	BMT 	Telangana 		
Begu Sarai 	BGS 	Bihar 		
Behtagokul 	BEG 			
Behula 		West Bengal 	ER/Eastrn Railway 	
Bejnal 	BJN 			
Bela Tal 	BTX 	Uttar Pradesh 		
Belampalli 	BPA 	Telangana 		
Belapur 	BAP 	Maharashtra 		
Belgahna 	BIG 			
Belgharia 	BEL 	WEST BENGAL 		
Belgaum 	BGM 	Karnataka 		
Belha 	BYL 			
Bellary Junction 	BAY 	Karnataka 		
Bellary Cantonment 	BYC 	Karnataka 		
Belpahar 	BPH 	Odisha 		
Belrayan 	BXM 			
Belsiri 	BLRE 			
Belthara Road 	BLTR 	Uttar Pradesh 		
Belur 	BEQ 			
Belvandi 	BWD 			
Beohari 	BEHR 	Madhya Pradesh 		
Berchha 	BCH 	Madhya Pradesh 		
Berhampore Court 	BPC 	West Bengal 	ER/Eastern Railway 	
Brahmapur 	BAM 	Odisha 		
Besroli 	BSRL 			
Betavad 	BEW 			
Bettiah 	BTH 	Bihar 		
Betul 	BZU 	Madhya Pradesh 		
Bhabhar 	BAH 			
Bhabua Road 	BBU 	Bihar 	ECR/East Central Railway 	
Bhachau 	BCO 	Gujarat 		
Bhachau BG 	BCOB 	Gujarat 		
Bhadan 	BDN 	Uttar Pradesh 	NCR/North Central Railway 	
Bhadaura 	BWH 			
Bhadbhadaghat 	BVB 			
Bhadli 	BDI 			
Bhadohi 	BOY 	Uttar Pradesh 		
Bhadra 	BHD 	Rajasthan 		
Bhadrachalam Road 	BDCR 	Telangana 		
Bhadrak 	BHC 	Odisha 		
Bhadran 		Gujarat 		
Bhadravati 	BDVT 	Karnataka 		
Bhadroli 	BBY 			
Bhaga Junction 	VAA 			
Bhagalpur 	BGP 	Bihar 		
Bhagat Ki Kothi 	BGKT 	Rajasthan 		
Bhagega 	BAGA 			
Bhagtanwala 	BGTN 			
Bhagwanpur 	BNR 			
Bhagwanpura 	BGPR 			
Bhaini Khurd 	BZK 	Haryana 		
Bhairongarh 	BOG 			
Bhakti Nagar 	BKNG 	Gujarat 	129.63
Bhalki 	BHLK 	Karnataka 	SCR 	
Bhalumaska 	BLMK 	Odisha 	ECoR 	
Bhanapur 	BNP 			
Bhandak 	BUX 	Maharashtra 		
Bhandara Road 	BRD 	Maharashtra 		
Bhandup 		Maharashtra 	CR/Central
Bhanga 	BXG 	Assam 	NFR/Northeast Frontier 	21 m 	[34]
Bhankoda 	BKD 			
Bharat Kup 	BTKP 			
Bharatkund 	BTKD 			
Bharatpur Junction 	BTE 	Rajasthan 		
Bharatwada 	BWRA 			
Bharthana 	BNT 	Uttar Pradesh 	NCR/North Central Railway 	135 m 	[35]
Bharuch Junction 	BH 	Gujarat 		
Bharwa Sumerpur 	BSZ 			
Bharwari 	BRE 			
Bhatel 	BHTL 			
Bhatgaon 	BOV 			
Bhatinda Junction 	BTI 	Punjab 		
Bhatiya 	BHV 			
Bhatkal 	BTKL 	Karnataka 		
Bhatni Junction 	BTT 	Uttar Pradesh 		
Bhaton Ki Gali 	BHG 			
Bhatpar Rani 	BHTR 			
Bhatpur 	BTPR 			
Bhattu 	BHT 	Haryana 		
Bhaunra 	BNVD 			
Bhavanagar Para 	BVP 	Gujarat 		
Bhavani Nagar 	BVNR 			
Bhavnagar Terminus 	BVC 	Gujarat 	
Bhawani Mandi 	BWM 	Rajasthan 		
Bhawanipatna 	BWIP 	Odisha 	East Coast 	
Bhawanipur Kalan 	BWP 			
Bhayandar 	BYR 	Maharashtra 	WR/Western
Bhayavadar 	BHY 	Gujarat 		
Bheempura 	BIPR 	Rajasthan 		
Bheerpur 	BEP 			
Bhemswadi 	BSWD 			
Bheraghat 	BRGT 	Madhya Pradesh 		
Bhesana 	BFY 			
Bhigwan 	BGVN 			
Bhilad 	BLD 	Gujarat 		
Bhilai Power House 	BPHB 	Chhattisgarh 		
Bhilainagar 	BQR 	Chhattisgarh 		
Bhilavdi 	BVQ 			
Bhildi 	BLDI 	Gujarat 		
Bhilwara 	BHL 	Rajasthan 		
Bhimal 	BIML 			
Bhimana 	BMN 			
Bhimarlai 	BMQ 			
Bhimasar 	BMSR 			
Bhimavaram Junction 	BVRM 	Andhra Pradesh 		
Bhimavaram Town 	BVRT 	Andhra Pradesh 		
Bhimnath 	BNH 			
Bhimsen 	BZM 	Uttar Pradesh 		
Bhind 	BIX 	Madhya Pradesh 		
Bhinwaliya 	BWA 			
Bhitaura 	BTO 			
Bhivpuri Road 		Maharashtra 	CR/Central
Bhiwandi 	BIRD 	Maharashtra 	CR/Central 	
Bhiwani 	BNW 	Haryana 		
Bhiwani City 	BNWC 	Haryana 		
Bhodwal Majri 	BDMJ 	Haryana 		
Bhogpur Sirwal 	BPRS 	Punjab 		
Bhojipura Junction 	BPR 	Uttar Pradesh 		
Bhojo 	BOJ 			
Bhojras 	BHAS 			
Bhojudih Junction 	BJE 	Jharkhand 	ECR/East Central Railway 	
Bhoke 	BOKE 			
Bhone 	BHNE 			
Bhongaon 	BGQ 	Uttar Pradesh 		
Bhongir 	BG 	Telangana 		
Bhopal Bairagarh 	BIH 	Madhya Pradesh 		
Bhopal Dewanganj 	DWN 	Madhya Pradesh 		
Bhopal Habibganj 	HBJ 	Madhya Pradesh 		
Bhopal Junction 	BPL 	Madhya Pradesh 		
Bhopal Mandideep 	BMND 	Madhya Pradesh 		
Bhopal Misrod 	BMSD 	Madhya Pradesh 		
Bhopal Nishatpura 	BNTP 	Madhya Pradesh 		
Bhubaneshwar 	BBS 	Odisha 	ECoR/ East Coast 	
Bhuj 	BHUJ 	Gujarat 		
Bhupalsagar 	BSJ 			
Bhupia Mau 	VPO 			
Bhusaval Junction 	BSL 	Maharashtra 		
Bhutakia Bhimsa 	BUBR 			
Bhusaval 	BSL 	Maharashtra 		
Bibinagar Junction 	BN 	Telangana 		
Bichia 	BIC 			
Bichpuri 	BCP 	Uttar Pradesh 		
Bidadi 	BID 	Karnataka 		
Bidanpur 	BDNP 			
Bidar 	BIDR 	Karnataka 		
Bidhan Nagar Road 	BNXR 	West Bengal 	ER/Eastern Railway 	
Bidupur 	BIU 	[Bihar] 		
Bidyadabri 	BDYR 	Assam 	NFR/Northeast Frontier 	31 m 	[36]
Bighapur 	BQP 			
Bihara 	BHZ 	Assam 	NFR/Northeast Frontier 	29 m 	[37]
Bihar Sharif 	BEHS 	Bihar 		
Bihiya 	BEA 	Bihar 		
Bihta 	BTA 	[Bihar] 		
Bijainagar 	BJNR 			
Bijapur 	BJP 	Karnataka 		
Bijauli 	BJI 			
Bijaysota 	VST 			
Bijni 	BJF 	Assam 	NFR/Northeast Frontier 	55 m 	[38]
Bijnor 	BJO 	Uttar Pradesh 		
Bijoor 	BIJR 	Karnataka 		
Bijora 	BJK 			
Bijrotha 	BJA 			
Bijuri 	BJRI 			
Bikaner Junction 	BKN 	Rajasthan 		
Bikrampur 	BMR 			
Bilaspur 	BSP 	Chhattisgarh 	SECR / South East Central 	
Bilaspur Road 	BLOR 	Himachal Pradesh 		
Bildi 	BILD 			
Bilhar Ghat 	BLG 			
Bilhaur 	BLU 			
Bilimora Junction 	BIM 	Gujarat 		
Bilkha 	BILK 			
Billi 	BXLL 			
Bilpur 	BLPU 			
Bilwai 	BWI 			
Bina Junction 	BINA 	Madhya Pradesh 		
Binaur 	BNAR 			
Bindki Road 	BKO 	Uttar Pradesh 		
Binnaguri 	BNV 	West Bengal 	NFR/Northeast Frontier Railway 	
Bir 	BIR 			
Biradhwal 	BDWL 			
Birambad 	BAMA 			
Birang Khera 	BMK 			
Birapatti 	BRPT 			
Birlanagar 	BLNR 	Madhya Pradesh 		
Birmitrapur 	BRMP 	Odisha 		
Birohe 	BEO 			
Biroliya 	BRLY 			
Birsinghpur 	BRS 			
Birur Junction 	RRB 	Karnataka 		
Bisalwas Kalan 	BIWK 			
Bishengarh 	BISH 	Rajasthan 		
Bishnathganj 	BTJ 			
Bishnupur railway station 	VSU 	West Bengal 	ER/Eastern Railway 	
Bishrampur 	BSPR 	Chhattisgarh 		
Bissam Cuttack 	BMCK 	Odisha 	
Bissau 	BUB 	Rajasthan 		
Biswa Bridge 	BIS 	Maharashtra 		
Biswan 	BVN 			
Biyavra 	BVR 	Madhya Pradesh 		
Biyavra Rajgarh 	BRRG 	Madhya Pradesh 		
Bobas 	BOBS 			
Bobbili Junction 	VBL 	Andhra Pradesh 		
Bodeli 	BDE 	Gujarat 		
Bodhan 	BDHN 	Telangana 		
Bodwad 	BDWD 			
Boinda 	BONA 	Odisha 		
Boisar 	BOR 	Maharashtra 	WR/Western 	
Bokajan 	BXJ 	Assam 		
Bokaro Steel City 	BKSC 	Jharkhand 	ECR/East Bentral Railway 	
Bokaro Thermal 	BKRO 	Jharkhand 	ECR/East Bentral Railway 	
Boko 	BOKO 	Assam 	NFR/Northeast Frontier 	48 m 	[39]
Bolai 	BLX 			
Bolarum 	BMO 	Telangana 		
Bolda 	BLC 			
Bolpur — Santiniketan 	BHP 	West Bengal 	ER/Eastern Railway 	
Bombay Masjid 	MSD 	Maharashtra 		
Bommidi 	BQI 	Andhra Pradesh 		
Bongaigaon 	BNGN 	Assam 	NFR/Northeast Frontier 	60 m 	[40]
Borawar 	BOW 	Rajasthan 		
Bordhal 	BXY 			
Bordi 	BIO 			
Borgaon 	BGN 			
Borivali 	BVI 	Maharashtra 	WR/Western 	
Borra Guhalu 	BGHU 	Andhra Pradesh 		
Borvihir 	BRVR 			
Botad Junction 	BTD 	Gujarat 		
Boxirhat 	BXHT 	Assam 	NFR/Northeast Frontier 	31 m 	[41]
Brahmavart 	BRT 			
Brajarajnagar 	BRJN 	Odisha 		
Brayla Chaurasi 	BRLA 			
Budalur 	BAL 			
Budaun 	BEM 	Uttar Pradesh 		
Budhi 	BDHY 			
Budhlada 	BLZ 	Punjab 		
Budni 	BNI 	Madhya Pradesh 		
Bulandshahr 	BSC 	Uttar Pradesh 		
Bundi 	BUDI 	Rajasthan 		
Bundki 	BEK 			
Burdwan 		West Bengal 	ER/Eastern Railway 	
Burhanpur 	BAU 	Madhya Pradesh 		
Burhar 	BUH 	Madhya Pradesh 		
Burhwal 	BUW 			
Burnpur 	BURN 	West Bengal 	ER/Eastern Railway 	
Butari 	BTR 			
Butewala 	BWF 			
Buxar 	BXR 	Bihar 		
Byadarahalli 	BDRL 	Karnataka 		
Byculla 	BY 	Maharashtra 	CR/Central
Boridand 	BRND 	Chhattisgarh 		
Birati 	BBT 	West Bengal 	ER/Eastern Railway 	
Barai Jalalpur 		Sitapur Uttar Pradesh 		
Bangaon Junction 	BNJ 	[West Bengal] 	ER/Eastern Railway 	
B B D Bag 	BBDB 	West Bengal 	ER/Eastern Railway 	
Budge Budge 	BGB 	West Bengal 	ER/Eastern Railway 	
Bamangachi 	BMG 	West Bengal 	ER/Eastern Railway 	
Bira 	BIRA 	West Bengal 	ER/Eastern Railway 	
Bidhutibhushan Halt 	BNAA 	West Bengal 	ER/Eastern Railway 	
Belur 	BEQ 	West Bengal 	ER/Eastern Railway 	
Belur Math 	BEQM 	West Bengal 	ER/Eastern Railway 	
Bisharpara Kodaliya 	BRPK 	West Bengal 	ER/Eastern Railway 	
Baghbazar 	BBR 	West Bengal 	ER/Eastern Railway 	
Barabazaar 	BZR 	West Bengal 	ER/Eastern Railway 	
Birnagar 	BIJ 	West Bengal 	ER/Eastern Railway 	
C
Station Name 	Station Code 	State 	Railway Zone 	Elevation 	Map
C Shahumaharaj T 	KOP 	Maharashtra 		
Calicut 	CLT 	Kerala 		
Canacona 	CNO 	Goa 	KRCL 	
Cannanore 	CAN 	Kerala 		
Cannanore South 	CS 	Kerala 		
Cansaulim 	CSM 			
Carmelaram (Sarjapur Road, Bangalore) 	CRLM 	Karnataka 	Zone: SWR/South Western, Division: Bangalore 		[42]
Castle Rock 	CLR 	Karnataka 		
CBD Belapur 	BR 	Maharashtra 	Harbour (CR)
Chandanathope 		Kerala 		
Chabua 	CHB 	Assam 		
Chachaura Bngj 	CBK 			
Chadotar 	CDQ 			
Chaibasa 	CBSA 	Jharkhand 		
Chainwa 	CW 			
Chajawa 	CJW 			
Chajli 	CJL 			
Chakdaha 	CDH 	West Bengal 		
Chakdayala 	CKDL 			
Chakehri(Kanpur) 	CHK 	Uttar Pradesh 		
Chakia 	CAA 	Bihar 		
Chakradharpur 	CKP 	Jharkhand 		
Chakraj Mal 	CAJ 			
Chaksu 	CKS 	Rajasthan 		
Chakulia 	CKU 	Jharkhand 		
Chalakudi 	CKI 	Kerala 		
Chalala 	CLC 	Gujarat 		
Chalisgaon Junction 	CSN 	Maharashtra
Challakere 	CLK 	Karnataka 		
Chalthan 	CHM 	Gujarat 		
Chamagram 	CMX 			
Chamarajanagar 	CMNR 	Karnataka 		
Champa 	CPH 	Chhattisgarh 		
Champaner Rd Junction 	CPN 			
Chamraura 	CHRU 			
Chand Siau 	CPS 			
Chanda Fort 	CAF 	Maharashtra 		
Chandan Nagar 	CGR 	West Bengal 		
Chandar 	CNR 			
Chandari(Kanpur) 	CNBI 	Uttar Pradesh 		
Chandauli Majhwar 	CDMR 	Uttar Pradesh 		
Chandausi Junction 	CH 	Uttar Pradesh 		
Chandawal 	CNL 			
Chanderiya 	CNA 			
Chandi Mandir 	CNDM 	Himachal Pradesh 		
Chandia Road 	CHD 	Madhya Pradesh 		
Chandigarh 	CDG 	Chandigarh 		
Chandil Junction 	CNI 	Jharkhand 		
Chandiposi 	CPE 			
Chandisar 	CDS 			
Chandkhira Bagn 	CHBN 	Assam 	NFR/Northeast Frontier 	39 m 	[43]
Chandlodiya 	CLDY 	Gujarat 		
Chandok 	CNK 	Uttar Pradesh 		
Chandranathpur 	CNE 	Assam 	NFR/Northeast Frontier 	37 m 	[44]
Chandrapur 	CD 	Maharashtra 		
Chandrapura 	CRP 	Jharkhand 		
Chandresal 	CDSL 			
Chandur 	CND 	Maharashtra 		
Chaneti 	CHTI 			
Changanacheri 	CGY 	Kerala 		
Changsari 	CGS 	Assam 	NFR/Northeast Frontier 	54 m 	[45]
Channani 	CHNN 			
Channapatna 	CPT 	Karnataka 		
Chanpatia 	CAI 	Bihar 		
Chaparmukh Junction 	CPK 	Assam 	NFR/Northeast Frontier 	65 m 	[46]
Chaprakata 	CPQ 	Assam 	NFR/Northeast Frontier 	57 m 	[47]
Charaud 	CRW 			
Charbagh Railway Station 	LKO 	Uttar Pradesh 		
Charbatia 	CBT 			
Charbhuja Road 	CBG 			
Chargola 	CGX 	Assam 	NFR/Northeast Frontier 	21 m 	[48]
Charkhari Road 	CRC 	Uttar Pradesh 		
Charkhi Dadri 	CKD 	Haryana 		
Charni Road 	CYR 	Maharashtra 	WR/Western
Charvattur 	CHV 			
Chata 	CHJ 	Uttar Pradesh 		
Chatrapati Shivaji Terminus 	CST 	Maharashtra 	CR/Central/Harbour
Chau Mahla 	CMU 			
Chaube 	CBH 			
Chaukhandi 	CHH 			
Chaunrah 	CNH 	Uttar Pradesh 		
Chaurakheri 	CRKR 			
Chaure Bazar 	CHBR 			
Chauri Chaura 	CC 	Uttar Pradesh 		
Chausa 	CSA 	Bihar 		
Chautara 	CROA 	Assam 	NFR/Northeast Frontier 	48 m 	[49]
Chauth Ka Brwra 	CKB 			
Chavalkhede 	CHLK 			
Chawapall 	CHA 			
Chaygaon 	CGON 	Assam 	NFR/Northeast Frontier 	48 m 	[50]
Chemancheri 	CMC 	Tamil Nadu 		
Chembur 	CM 	Maharashtra 	Harbour (CR)
Chengalpattu 	CGL 	Tamil Nadu 		
Chengannur 	CNGR 	Kerala 	SR/Southern 	6m 	
Chennai Beach 	MSB 	Tamil Nadu 		
Chennai Central 	MAS 	Tamil Nadu 		
Chennai Egmore 	MS 	Tamil Nadu 		
Chennai Fort 	MSF 	Tamil Nadu 		
Chennai Park 	MPK 	Tamil Nadu 		
Cheriyanad 	CYN 	Kerala 		
Cherthala 	SRTL 	Kerala 		
Chetar 	CTQ 			
Chettinad 	CTND 	Tamil Nadu 		
Chhabra Gugor 	CAG 			
Chhandrauli 	CDRL 			
Chhansara 	CASA 			
Chhapi 	CHP 	Gujarat 		
Chhapra 	CPR 	Bihar 		
Chhapra Kacheri 	CI 	Bihar 		
Chharodi 	CE 			
Chhatrapur 	CAP 	Odisha 		
Chhidgaon 	CGO 			
Chhina 	CHN 			
Chhindwara Junction 	CWA 	Madhya Pradesh 		
Chhipadohar 	CPDR 			
Chhitauni 	CTE 	Uttar Pradesh 		
Chhota Gudha 	COD 			
Chhoti Odai 	COO 			
Chianki 	CNF 	Jharkhand 		
Chidambaram 	CDM 	Tamil Nadu 		
Chiheru 	CEU 			
Chikballapur 	CBP 	Karnataka 		
Chikkamagaluru railway station 	CMGR 	Karnataka 	South Western Railway
Chikalthan 	CTH 			
Chikjajur Junction 	JRU 	Karnataka 		
Chikni Road 	CKNI 	Maharashtra 		
Chikodi Road 	CKR 	Karnataka 		
Chilbila Junction 	CIL 			
Chilka 	CLKA 	Odisha 		
Chilo 	CLO 			
Chinchli 	CNC 			
Chinchpada 	CPD 	Maharashtra 		
Chinchpokli 	CHG 	Maharashtra 	CR/Central
Chinchwad 	CCH 	Maharashtra 		
Chinna Ganjam 	CJM 	Andhra Pradesh 		
Chinna Salem 	CHSM 	Tamil Nadu
Chintamani 	CMY 	Karnataka 		
Chiplun 	CHI 	Maharashtra 	KR / Konkan Railway 	12 m 	[51]
Chipurupalle 	CPP 	Andhra Pradesh 		
Chirai 	CHII 			
Chirala 	CLX 	Andhra Pradesh 		
Chirawa 	CRWA 	Rajasthan 		
Chirayinkil 	CRY 	Kerala 		
Chirgaon 	CGN 	Uttar Pradesh 		
Chirmiri 	CHRM 	Chhattisgarh 		
Chit Baragaon 	CBN 			
Chitahra 	CTHR 			
Chital 	CTL 			
Chitali 	CIT 			
Chitradurga 	CTA 	Karnataka 		
Chitrakuta 	CKTD 	Madhya Pradesh 		
Chitrapur 	CTTP 	Karnataka 	KRCL
Chitrasani 	CTT 			
Chitrawad 	CTRD 			
Chitrod 	COE 			
Chitapur 	CT 	Karnataka 		
Chittaranjan 	CRJ 	West Bengal 		
Chittaurgarh 	COR 	Rajasthan 		
Chittoor 	CTO 	Andhra Pradesh 	SC Railway 	
Chodiala 	CDL 	Uttarakhand 		
Choki Sorath 	CKE 			
Chola 	CHL 			
Cholang 	CGH 			
Chomun Samod 	COM 	Rajasthan 		
Chondi 	CWI 			
Chopan 	CPU 	Uttar Pradesh 		
Choral 	CRL 			
Chorvad Road 	CVR 	Gujarat 		
Chosla 	CSL 			
Choti Khatu 	CTKT 			
Chuchura 	CNS 	West Bengal 		
Chuda 	CDA 			
Chunabhatti 		Maharashtra 	Harbour (CR)
Chunar 	CAR 	Uttar Pradesh 		
Churchgate 	CCG 	Maharashtra 	WR/Western 	
Churk 	CUK 	Uttar Pradesh 		
Churu 	CUR 	Rajasthan 		
Clutterbuckganj 	CBJ 	Uttar Pradesh 		
Cochin Harbour Terminus 	CHTS 	Kerala 		
Coimbatore Junction 	CBE 	Tamil Nadu 		
Coimbatore North Junction 	CBF 	Tamil Nadu 		
Colonelganj 	CLJ 	Uttar Pradesh 		
Contai Road 	CNT 	West Bengal 		
Coonoor 	ONR 	Tamil Nadu 		
Cotton Green 		Maharashtra 	Harbour (CR)
Cuddalore Junction 	COT 	Tamil Nadu 		
Cuddalore Port 	CUPJ 	Tamil Nadu 		
Cuddapah 	HX 	Andhra Pradesh 		
Cumbum 	CBM 	Tamil Nadu 		
Cuttack 	CTC 	Odisha 		
Currey Road 		Maharashtra 	CR/Central
D
Station Name 	Station Code 	State 	Railway Zone 	Elevation 	Map
Dabhaura 	DBR 		
Dabhoi Junction 	DB 		
Dabilpur 	DBV 	Telangana 	
Dabla 	DBLA 		
Dabli Rathan 	DBI 		
Dabolim 	DBM 		
Dabra 	DBA 	Madhya Pradesh 	
Dabtara 	DUB 		
Dadar (Western Railway) 	DDR 	Maharashtra 	WR/Western
Dadar (Central Railway) 	DR 	Maharashtra 	CR/Central
Dadri 	DER 		
Dagaon 	DGX 	Assam 	NFR/Northeast Frontier 	67 m 	[52]
Dagmagpur 	DAP 		
Dahanu Road 	DRD 	Maharashtra 	WR/Western
Dahar Ka Balaji 	DKBJ 		
Dahina Zainabad 	DZB 		
Dahisar 	DIC 	Maharashtra 	WR/Western
Dahod 	DHD 	Gujarat 	
Dailwara 	DWA 		
Dakaniya Talav 	DKNT 		
Dakhineswar 	DAKE 	West Bengal 	
Dakor 	DK 		
Daladi 	DL 		
Dalauda 	DLD 		
Dalelnagar 	DLQ 		
Dalgaon 	DLO 	West Bengal 	
Daliganj 	DAL 		
Dalhousie Road 	DALR 	Punjab 	
Dalkhola 	DLK 	West Bengal 	
Dalli-Rajhara 	DRZ 	Chhattisgarh 	
Dalmau Junction 	DMW 		
Dalmera 	DLC 		
Dalpatpur 	DLP 		
Dalsingh Sarai 	DSS 	Bihar 	
Daltonganj 	DTO 	Jharkhand 	
Damanjodi 	DMNJ 	Odisha 	
Damchara 	DCA 	Assam 	NFR/Northeast Frontier 	55 m 	[53]
Damnagar 	DME 		
Damoh 	DMO 	Madhya Pradesh 	
Danapur 	DNR 	Bihar
Dandeli 	DED 		
Dandupur 	DND 		
Dangoaposi 	DPS 	Jharkhand 	
Dangtal 	DTX 	Assam 	NFR/Northeast Frontier 	52 m 	[54]
Daniyawan Bzr H 	DNWH 		
Dankaur 	DKDE 		
Dankuni 	DKAE 	West Bengal 	ER/Eastern Railways 	7 m 	[55]
Danwar 	DAR 		
Dapodi 	DAPD 		
Dappar 	DHPR 	Punjab 	
Daotuhaja 	DJA 	Assam 	NFR/Northeast Frontier 	401 m 	[56]
Dara 	DARA 		
Daraganj 	DRGJ 		
Darbhanga Junction 	DBG 	Bihar
Darjeeling 	DJ 	West Bengal
Darritola 	DTL 	Chhattisgarh 	
Daryabad 	DYD 	Uttar Pradesh
Daryapur 	DYP 		
Dasna 	DS 		
Dasuya 	DZA 	Punjab 	Northern Railway 		
Datia 	DAA 	Madhya Pradesh 	
Dativali 		Maharashtra 	CR/Central
Daudpur 	DDP 	Bihar
Daulatabad 	DLB 		
Daund Junction 	DD 	Maharashtra 	
Daundaj 		Maharashtra 	
Daurai 	DOZ 		
Daurala 	DRLA 		
Dauram Madhpura 	DMH 		
Dausa 	DO 	Rajasthan 	
Dausni 	DSNI 		
Davangere 	DVG 	Karnataka 	
Dayalpur 	DLPR 		
Debari 	DRB 		
Debipur 	DBP 	ER/Eastern Railways 		
Degana Junction 	DNA 		
Dehradun 	DDN 	Uttranchal 	
Dehri On Sone 	DOS 	Bihar
Dehu Road 	DEHR 		
Dekapam 	DKPM 		
Delhi 	DLI 	Delhi 	
Delhi MG 	DE 	Delhi 	
Delhi Azadpur 	DAZ 	Delhi 	
Delhi Cantonment 	DEC 	Delhi 	
Delhi Kishanganj 	DKZ 	Delhi 	
Delhi Sarai Rohilla 	DEE 	Delhi 	
Delhi Safdarjung 	DSJ 	Delhi 	
Delhi Shahdara 	DSA 	Delhi 	
Delvada 	DVA 	Gujarat 	
Demu 	DEMU 		
Deoband 	DBD 	Uttar Pradesh 	
Deogan Road 	DFR 		
Deorakot 	DELO 		
Deoria Sadar 	DEOS 	Uttar Pradesh 	
Depalsar 	DEP 		
Derol 	DRL 		
Desari 	DES 		
Deshalpar 	DSLP 		
Deshnok 	DSO 	Rajasthan 	
Deswal 	DSL 		
Detroj 	DTJ 		
Devakottai Road 	DKO 	Tamil Nadu 	
Devbaloda Charoda 	DBEC 	Chhattisgarh 	
Devgam 	DVGM 		
Devgarh Madriya 	DOHM 		
Devlali 	DVL 	Maharashtra 	
Devpura 	DPZ 		
Dewalgaon 	DEW 		
Dewanganj 	DWG 	Madhya Pradesh 	
Dewas 	DWX 	Madhya Pradesh 	
Dhaban 	DABN 		
Dhalaibil 	DQL 		
Dhalgaon 	DLGN 	Maharashtra 	
Dhalpukhuri 	DHRY 	Assam 	NFR/Northeast Frontier 	84 m 	[57]
Dhamangaon 	DMN 	Maharashtra 	
Dhamni 	DNE 		
Dhamora 	DAM 		
Dhampur 	DPR 		
Dhamtari 	DTR 	Chhattisgarh 	
Dhamua 	DMU 		
Dhana Kherli 	DXK 		
Dhanakwada 	DKW 		
Dhanakya 	DNK 		
Dhanari 	DN 		
Dhanawala Wada 	DHVR 		
Dhanbad Junction 	DHN 	Jharkhand 	
Dhandari Kalan 	DDL 		
Dhandhera 	DNRA 		
Dhandhuka 	DCK 		
Dhanera 	DQN 	Gujarat 	
Dhaneta 	DAN 		
Dhangadra 	DNG 	Gujarat 	
Dhanmandal 	DNM 	Odisha 	
Dharamtul 	DML 	Assam 	NFR/Northeast Frontier 	59 m 	[58]
Dharangaon 	DXG 	Maharastra 	
Dhareshwar 	DRS 		
Dhari Junction 	DARI 		
Dhariwal 	DHW 	Punjab 	
Dharmabad 	DAB 	Maharashtra 	
Dharmanagar 	DMR 	Tripura 	
Dharmapuri 	DPJ 	Tamil Nadu 	
Dharmavaram Junction 	DMM 	Andhra Pradesh 	
Dharmpur Himachal 	DMP 	Himachal Pradesh 	
Dharnaoda 	DHR 		
Dharwad 	DWR 	Karnataka 		731.52
Dhasa Junction 	DAS 		
Dhaulpur 	DHO 	Rajasthan 	NCR
Dhaura 	DUA 		
Dheena 	DHA 		
Dhekiajili Road 	DKJR 		
Dhemaji 	DMC 	Assam 	
Dhenkanal 	DNKL 	Odisha 	
Dhilwan 	DIW 		
Dhinda 	DHND 		
Dhindhora HKMKD 	DNHK 		
Dhindsa 	DDK 		
Dhing 	DIU 	Assam 	NFR/Northeast Frontier 	65 m 	[59]
Dhing Bazar 	DBZ 	Assam 	NFR/Northeast Frontier 	66 m 	[60]
Dhinoj 	DHJ 		
Dhirera 	DHRR 		
Dhirganj 	DHRJ 		
Dhirpur 	DPP 	Haryana 	
Dhoda Khedi 	DHKR 	Haryana 	
Dhodhar 	DOD 		
Dhodra Mohar 	DOH 		
Dhola Junction 	DLJ 	Gujarat 	
Dhola Mazra 	DHMZ 		
Dholi 	DOL 		
Dholka 	DOK 		
Dhondi 	DNDI 		
Dhoraji 	DJI 		
Dhrangadhra Junction 	DHG 	Gujarat 	
Dhubri 	DBB 	Assam 	NFR/Northeast Frontier 	30 m 	[61]
Dhule 	DHI 	Maharashtra 	
Dhulghat 	DGT 		
Dhulkot 	DKT 	Haryana 	
Dhup Dhara 	DPRA 	Assam 	NFR/Northeast Frontier 	49 m 	[62]
Dhupguri 	DQG 		
Dhuri Junction 	DUI 	Punjab 	
Dibai 	DIB 		
Dibrugarh 	DBRG 	Assam 	NFR/Northeast Frontier 	108 m 	
Dibrugarh Town 	DBRT 	Assam 	
Dichpalli 	DHP 	Telangana 	
Didwana 	DIA 		
Digaru 	DGU 	Assam 	NFR/Northeast Frontier 	58 m 	[63]
Digboi 	DBY 	Assam 	
Dighwara 	DGA 		
Digod 	DXD 		
Dihakho 	DKE 	Assam 	NFR/Northeast Frontier 	202 m 	[64]
Dilawarnagar 	DIL 		
Dildarnagar Junction 	DLN 	Uttar Pradesh 	
Dimapur 	DMV 	Nagaland 	
Dimow 	DM 		
Dina Nagar 	DNN 		
Dinagaon 	DIQ 		
Dindigul Junction 	DG 	Tamil Nadu 	
Dingwahi 	DWI 		
Dipa 	DIPA 		
Diphu 	DPU 	Assam 	
Diplana 	DPLN 		
Dipore 	DIP 	Maharashtra 	
Disa 	DISA 	Gujarat 	
Ditokcherra 	DTC 	Assam 	NFR/Northeast Frontier 	115 m 	[65]
Diva Junction 		Maharashtra 	CR/Central
Divine Nagar 	DINR 	Kerala 	
Diwana 	DWNA 	Haryana 	
Diwankhavati 	DWV 		
Diyodar 	DEOR 		
Dobh Bahali 	DBHL 		
Dockyard Road 		Maharashtra 	Harbour (CR)
Dodballapur 	DBU 	Karnataka 	
Dodbele 	DBL 		
Dohrighat 	DIT 		
Doiwala 	DWO 		
Dolavli 		Maharashtra 	CR/Central
Dombivli 	DI 	Maharashtra 	CR/Central
Domingarh 	DMG 		
Donakonda 	DKD 	Andhra Pradesh 	
Dondaicha 	DDE 	Maharashtra 	
Dongargaon 	DGN 	Madhya Pradesh 	
Dongargarh 	DGG 	Chhattisgarh 	
Donigal 	DOG 		
Doraha 	DOA 		
Doravart Chtram 	DVR 		
Dornakal Junction 	DKJ 	Telangana 	
Dronachalam Junction 	DNC 	Andhra Pradesh 	
Dubaha 	DUBH 		
Dubia 	DBW 		
Duddhinagar 	DXN 	Uttar Pradesh 	
Dudh Sagar 	DDS 		
Dudhsagar Waterfalls 	DWF 	Goa 	[66]
Dudhani 	DUD 		
Dudhia Khurd 	DYK 		
Dudhnoi 	DDNI 	Assam 	NFR/Northeast Frontier 	50 m 	[67]
Dudhwakhara 	DKX 		
Dudia 	DUK 	Rajasthan 	
Dudwindi 	DDY 		
Duganpur 	DUN 		
Dugdol 	DGQ 	Gujarat 	
Duggirala 	DIG 	Andhra Pradesh 	
Duhai 	DXH 		
Duliajan 	DJG 	Assam 	
Dullabcherra 	DLCR 	Assam 	NFR/Northeast Frontier 	42 m 	[68]
Dullahapur 	DLR 		
Dulrasar 	DUS 		
Dum Dum 	DDJ 	West Bengal 	ER/Eastern Railway 		
Dum Dum Cantonment 	DDC 	West Bengal 	ER/Eastern Railway 		
Dumariya 	DY 		
Dumraon 	DURE 		
Dumka 	DMKA 	Jharkhand 	
Dumuriput 	DMRT 	Odisha 	ECoR / East Coast
Dundara 	DOR 	Rajasthan 	
Dundlod MKDGRH 	DOB 		
Dungar Junction 	DGJ 		
Dungarpur 	DNRP 	Rajasthan 	
Duraundha Junction 	DDA 		
Durgauti 	DGO 		
Durg 	DURG 	Chhattisgarh 	
Durgapur 	DGR 	West Bengal 	
Duttapukur 	DTK 	West Bengal 	
Durgapura 	DPA 		
Duskheda 	DSK 		
Duvvada 	DVD 	Andhra Pradesh 	
Dwarka 	DWK 	Gujarat 	
Dwarkaganj 	DWJ 		
E
Station Name 	Station Code 	State 	Railway Zone 	Elevation 	Map
Ekangarsarai 	EKR 		
Ekchari 	EKC 		
Ekma 	EM 	Kerala 	
Ekma 	EKMA 	Bihar 	
Elamanur 	EL 		
Elamanchili 	YLM 	Andhra Pradesh 	
Ellenabad 	ENB 	Haryana 	
Elphinstone Road 	EPR 	Maharashtra 	WR/Western
Eluru 	EE 	Andhra Pradesh 	
Ennore 	ENR 	Tamil Nadu 	SR/Southern 	7 m 	
Eraligu 	ELL 	Assam 	NFR/Northeast Frontier 	35 m 	[69]
Eraniel 	ERL 	Tamil nadu 	
Ernakulam Junction 	ERS 	Kerala 	
Ernakulam Town 	ERN 	Kerala 	
Ernakulam Terminus 	ERG 	Kerala 	
Erode Junction 	ED 	Tamil Nadu 	
Etah 	ETAH 	Uttar Pradesh 	
Etawah 	ETW 	Uttar Pradesh 	
Ettimadai(Coimbatore) 	ETMD 	Tamil Nadu
Etmadpur 	ETUE 	Uttar Pradesh 	
Etakkot 	ETK 	Kerala 	
F
Station Name 	Station Code 	State 	Railway Zone 	Elevation 	Map
Faizabad Junction 	FD 	Uttar Pradesh 	
Faizullapur 	FYZ 		
Fakhrabad 	FKB 		
Fakiragram Junction 	FKM 	Assam 	NFR/Northeast Frontier 	43 m 	[70]
Falakata 	FLK 	West Bengal 	
Falna 	FA 	Rajasthan 	
Farah Town 	FHT 	Uttar Pradesh 	
Farhedi 	FRD 		
Faridabad 	FDB 	Haryana 	
Faridabad New Town 	FDN 	Haryana 	
Faridkot 	FDK 	Punjab 	
Farrukhabad 	FBD 	Uttar Pradesh 	
Farrukhabad 	FKD 		
Fateh Singhpura 	FSP 		
Fatehabad Chandrawati Ganj Junction 	FTD 	Madhya Pradesh 	
Fatehgarh 	FGR 		
Fatehgarh Sahib 	FGSB 	Punjab 	
Fatehnagar 	FAN 		
Fatehpur 	FTP 		
Fatehpur Sikri 	FTS 	Uttar Pradesh 	
Fatehpur Sekhawati 	FPS 	Rajasthan 	
Fatwa 	FUT 	Bihar 	ECR(Eastern Central Railway) 	
Fazalpur 	FZL 		
Fazilka 	FKA 	Punjab 	
Ferok 	FK 	Kerala 	
Firozabad 	FZD 	Uttar Pradesh 	
Firozpur Cant. 	FZR 	Punjab 	
Firozpur City 	FZP 	Punjab 	
Forbesganj 	FBG 	Bihar 	
Furkating Junction 	FKG 	Assam 	
Fursatganj 	FTG 		
G
Station Name 	Station Code 	State 	Railway Zone 	Elevation 	Map
Gachhipura 	GCH 		
Gadag Junction 	GDG 	Karnataka 	
Gadarwara 	GAR 	Madhya Pradesh 	WCR/Jabalpur 	357.77 M 	[71]
Gadhakda 	GKD 		
Gadra Road 	GDD 		
Gadwal 	GWD 	Telangana 	
Gahmar 	GMR 	Uttar Pradesh 	
Gainjahwa 	GAW 		
Gainsari Junction 	GIR 		
Gaipura 	GAE 		
Gajraula Junction 	GJL 	Uttar Pradesh 	
Galan 	GAA 		
Gambhiri Road 	GRF 		
Ganagapur Road 	GUR 		
Ganj Dundwara 	GWA 		
Ganaur 	GNU 	Haryana 	
Gandhi SMRAK_RD 	GSX 		
Gandhidham BG 	GIMB 	Gujarat 	
Gandhidham Junction 	GIM 	Gujarat 	
Gandhigram 	GG 		
Gandhinagar JPR 	GADJ 	Rajasthan 	
Gandhinagar Capital 	GNC 	Gujarat 	
Ganeshganj 	GAJ 		
Gangaganj 	GANG 		
Gangakher 	GNH 	Maharashtra 	
Gangapur City 	GGC 	Rajasthan 	
Gangrar 	GGR 		
Gangsar Jaitu 	GJUT 	Haryana 	
Ganj basoda 	BAQ 	Madhya Pradesh 	
Ganjmuradabad 	GJMB 		
Gannavaram 	GWM 	Andhra Pradesh 	
Garhi Harsaru 	GHH 	Haryana 	
Garhi Manikpur 	GRMR 		
Garhmuktesar 	GMS 	Uttar Pradesh 	
Garhmuktesar BR 	GGB 	Uttar Pradesh 	
Garhwa 	GHQ 	Jharkhand 	
Garot 	GOH 		
Garwa Road 	GHD 	Jharkhand 	
Gaura 	GRX 		
Gauri Bazar 	GB 		
Gauri Phanta 	GPF 	Uttarakhand 	
Gauribidanur 	GBD 	Karnataka 	
Gauriganj 	GNG 	Uttar Pradesh 	
Gauripur 	GUP 	Assam 	NFR/Northeast Frontier 	32 m 	[72]
Gauriyamau 	GMU 		
Gaushala 	GWS 		
Gautampura Road 	GPX 		
Gaya Junction 	GAYA 	Bihar 	
Geratpur 	GER 		
Gerita Kolvada 	GTKD 		
Gevra Road 	GAD 	Chhattisgarh 	
Gevrai 	GOI 	Maharashtra 	
Ghagghar 	GHG 	Punjab 	
Ghagwal 	GHGL 		
Ghanauli 	GANL 		
Ghansoli 		Maharashtra 	Trans-Harbour (CR)
Gharaunda 	GRA 	Haryana 	
Ghaso 	GSO 		
Ghataka Varana 	GKB 		
Ghatampur 	GTM 		
Ghatkopar 	G 	Maharashtra 	CR/Central
Ghatprabha 	GPB 	Karnataka 	
Ghatsila 	GTS 	Jharkhand 	
Ghaziabad 	GZB 	Uttar Pradesh 	
Ghazipur City 	GCT 		
Ghograpur 	GOE 	Assam 	NFR/Northeast Frontier 	55 m 	[73]
Gholvad 	GVD 	Maharashtra 	
Ghoradongri 	GDYA 	Madhya Pradesh 	
Ghorawadi 	GRWD 		
Ghorpuri 	GPR 		
Ghosipura 	GOPA 		
Ghosunda 	GSD 		
Ghughuli 	GH 		
Ghugus 	GGS 	Maharashtra 	
Ghutai 	GTI 		
Gidarpindi 	GOD 	Punjab 	
Giddalur 	GID 	Andhra Pradesh 	
Giddarbaha 	GDB 		
Gidhaur 	GHR 		
Gir Gadhara 	GEG 		
Gir Hadmatiya 	GRHM 		
Giridih 	GRD 	Jharkhand 	East Central Railway 	289m 	[74]
Girwar 	GW 		
Goalpara Town 	GLPT 	Assam 	NFR/Northeast Frontier 	49 m 	[75]
Godha 	GDHA 		
Godhra Junction 	GDA 	Gujarat 	
Gogameri 	GAMI 		
Gogamukh 	GOM 		
Gohad Road 	GOA 		
Gohana 	GHNA 	Haryana 	
Gohpur 	GPZ 		
Gokak Road 	GKK 	Karnataka 	
Gokarna Road 	GOK 	Karnatak 	KRCL 	
Gola Gokarannath 	GK 	Uttar Pradesh 	
Gola Road 	GRE 		
Golakganj Junction 	GKJ 	Assam 	NFR/Northeast Frontier 	31 m 	[76]
Golanthra 	GTA 		
Gole 	GOLE 		
Golsar 	GOZ 		
Gomati Nagar 	GTNR 		
Gomoh Junction 	GMO 	Jharkhand 	
Gonda Junction 	GD 		
Gondal 	GDL 	Gujarat 	
Gondia Junction 	G 	Maharashtra 	
Goneana 	GNA 		
Gooty 	GY 	Andhra Pradesh 	
Gop Jam 	GOP 		
Gopalganj 	GOPG 		
Gopalpur 	GPPR 		
Gora Ghuma 	GGM 		
Gorakhpur Cantonment 	GKC 	Uttar Pradesh 	
Gorakhpur City 	GKY 	Uttar Pradesh 	
Gorakhpur Junction 	GKP 	Uttar Pradesh 	
Goram Ghat 	GGO 		
Goraul 	GRL 		
Goraya 	GRY 		
Goregaon 	GMN 	Maharashtra 	WR/Western
Goregaon Road Halt 	GNO 	Maharashtra 	KR / Konkan Railway 	13 m 	[77]
Goresuar 	GVR 		
Goriyan 	GIO 		
Goshainganj 	GGJ 		
Gossaigaon Hat 	GOGH 	Assam 	NFR/Northeast Frontier 	50 m 	[78]
Gotan 	GOTN 		
Gotegaon 	GON 		
Gothaj 	GTE 		
Govandi 		Maharashtra 	Harbour (CR)
Goverdhan 	GDO 	Uttar Pradesh 	
Govindgarh 	GVG 		
Govindgarh Malk 	GND 		
Govindi Marwar 	GVMR 	Rajasthan 	
Govindnagar 	GOVR 		
Govindpuri 	GOV 	Uttar Pradesh 	
Govindpuri, Kanpur 	GOY 	Uttar Pradesh 	NCR/North Central Railway 	
Grant Road 	GTR 	Maharashtra 	WR/Western
Gudha 	GA 		
Guindy 		Tamil Nadu 	
Gubbi 	GBB 		
Gudivada Junction 	GDV 	Andhra Pradesh 	South Central Railway zone 	
Gudiyattam 	GYM 	Tamil Nadu 	
Gudur Junction 	GDR 	Andhra Pradesh 	
Gujhandi 	GJD 		
Gulabhganj 	GLG 		
Gulabpura 	GBP 		
Gulaothi 	GLH 		
Gularbhoj 	GUB 		
Gulbarga 	GR 	Karnataka 	
Guldhar 	GUH 	Uttar Pradesh 	
Guledagudda Rd 	GED 		
Guler 	GULR 		
Gulzarbagh 	GZH 		
Guma 	GUMA 		
Gumia 	GMIA 		
Gumman 	GMM 		
Gummidipundi 	GPD 	Tamil Nadu 	
Gumthal 	GTF 		
Guna 	GUNA 	Madhya Pradesh 	WR 	
Gundardehi 	GDZ 		
Guneru Bamori 	GVB 		
Guntakal Junction 	GTL 	Andhra Pradesh 	
Guntur Junction 	GNT 	Andhra Pradesh 	
Guptipara 	GPA 	West Bengal 	
Guraru 	GRRU 		
Gurap 	GRAE 	West Bengal 	
Gurdaspur 	GSP 		
Gurgaon 	GGN 	Haryana 	
Gurhi 	GUX 		
Guriya 	GRI 		
Gurla 	GQL 		
Gurmura 	GMX 		
Gurpa 	GAP 		
Gursahaiganj 	GHJ 		
Gursar Shnewala 	GSW 		
Gauravpur 	GUV 		
Guru Tegh Bahadur Nagar 		Maharashtra 	Harbour (CR)
Guruvayur 	GVR 	Kerala 	
Guwahati 	GHY 	Assam 	NFR/Northeast Frontier 	58 m 	[79]
Gwalior 	GWL 	Madhya Pradesh 	
Gyanpur Road 	GYN 	Uttar Pradesh 	
H
Station Name 	Station Code 	State 	Railway Zone 	Elevation 	Map
Hazrat Nizamuddin 	NZM 	Delhi 	
Habaipur 	HWX 	Assam 	NFR/Northeast Frontier 	93 m 	[80]
Habibganj 	HBJ 	Madhya Pradesh 	
Habibwala 	HBW 		
Hadapsar 	HDP 	Maharashtra 	
Hadmadiya 	HRM 		
Hadmatiya Junction 	HM 		
Hafizpur 	HZR 		
Haflong Hill 	HFG 	Assam 	NFR/Northeast Frontier 	543 m 	[81]
Haiaghat 	HYT 		
Haibargaon 	HBN 	Assam 	NFR/Northeast Frontier 	68 m 	[82]
Haidergarh 	HGH 		
Hailakandi 	HKD 	Assam 	NFR/Northeast Frontier 	28 m 	[83]
Hajipur Junction 	HJP 	Bihar 	
Hakimpur 	HKP 		
Haldaur 	HLDR 		
Haldi Road 	HLDD 		
Haldibari 	HDB 	West Bengal 	
Haldwani 	HDW 	Uttarakhand 	
Halisahar 	HLR 	West Bengal 	Eastern Railway
Halvad 	HVD 		
Hamira 	HMR 		
Hamirgarh 	HMG 		
Hamirpur Road 	HAR 	Himachal Pradesh 	
Hanakere 	HNK 		
Handia Khas 	HDK 		
Hansi 	HNS 	Haryana 	
Hansiawas 	HSWS 		
Hanumangarh Junction 	HMH 	Rajasthan 	
Hanumangarh town 	HMO 	Rajasthan 	
Hanwant 	HWT 	Rajasthan 	
Hapa 	HAPA 	Gujarat 	
Hapur 	HPU 	Uttar Pradesh 	
Harangajao 	HJO 	Assam 	NFR/Northeast Frontier 	154 m 	[84]
Harangul 	HGL 	Maharashtra 	CR/Central 	644 m 	[85]
Haranya Kheri 	HKH 		
Harauni 	HRN 		
Harawada 	HAA 	Karunadu 	KR 	
Harchandpur 	HCP 		
Harda 	HD 	Madhya Pradesh 	
Hardoi 	HRI 	Uttar Pradesh 	
Harduaganj 	HGJ 		
Haridwar Junction 	HW 	Uttarakhand 	
Harihar 	HRR 	Karnataka 	
Harinagar 	HIR 		Uttarakhand
Haripad 	HAD 	Kerala 	
Haripur 	HP 		
Harischandrapur 	HCR 	West Bengal 	
Harishankar Rd 	HSK 	Odisha 	
Harisinga 	HRSN 		
Harkia Khal 	HKL 		
Harmuti 	HMY 	Assam 	
Harnaut 	HRT 	Bihar 	
Harpalganj 	HRPG 		
Harpalpur 	HPP 	Uttar Pradesh 	
Harrawala 	HRW 		
Harsauli 	HSI 		
Harsud 	HRD 		
Harthala 	HRH 		
Harwada 	HAA 		
Hasimara 	HSA 	West Bengal 	
Hassan 	HAS 	Karnataka 	
Hasanparti Road 		Telangana 	
Hathbandh 	HN 	Chhattisgarh 	
Hathidah Junction 	HTZ 	Bihar 	
Hathigadh 	HTGR 		
Hathras City 	HTC 	Uttar Pradesh 	
Hathras Junction 	HRS 	Uttar Pradesh 	
Hathras Road 	HTJ 	Uttar Pradesh 	
Hathras Qilla 	HTJ 	Uttar Pradesh 	
Hatia 	HTE 	Jharkhand 	
Hatikhali 	HTL 	Assam 	NFR/Northeast Frontier 	289 m 	[86]
Hatkanagale 	HTK 		
Hatundi 	HTD 		
Haveri 	HVR 	Karnataka 	
Hazaribagh Road 	HZD 	Jharkhand 	
Hejjala 	HJL 	Karnataka 	SWR/South Western 	773 m 	[87]
Helak 	HK 		
Helem 	HML 		
Hempur 	HMP 		
Hendegir 	HNDR 		
Hilara 	HLX 	Assam 	NFR/Northeast Frontier 	24 m 	[88]
Hilsa 	HIL 	Bihar 	
Himayatnagar 	HEM 		
Himmatnagar 	HMT 	Gujarat 	
Hindaun City railway station 	HAN 	Rajasthan 	
Hind Motor 		West Bengal 	
Hindu College 	HC 	Tamil Nadu 	SR/Southern 	28 m 	
Hindumalkote 	HMK 		
Hindupur Junction 	HUP 	Andhra Pradesh 	
Hinganghat 	HGT 	Maharashtra 	
Hingoli Deccan 	HNL 	Maharashtra 	
Hira Nagar 	HRNR 		
Hirakud 	HKG 	Odisha 	
Hirapur 	HPR 		
Hirdagarh 	HRG 		
Hirnoda 	HDA 		
Hisar 	HSR 	Haryana 	
Hisvahal 	HSL 		
Hodal 	HDL 	Haryana 	
Hojai 	HJI 	Assam 	NFR/Northeast Frontier 	78 m 	
Hol 	HOL 		
Holambi Kalan 	HUK 	Delhi 	Northern Railway 	223.15 m
Hole Alur 	HLAR 	Karnataka 	
Honnavar 	HNA 	Karnataka 	KRCL 	
Hooghly 	HGY 	West Bengal 	
Hooghly Ghat 	HYG 	West Bengal 	
Hosdurga Road 	HSD 		
Hoshangabad 	HBD 	Madhya Pradesh 	
Hoshiarpur 	HSX 	Punjab 	
Hospet Junction 	HPT 	Karnataka 	
Hosur 	HSRA 	Tamil Nadu 	
Hotgi Junction 	HG 	Maharashtra 	
Howbadh Jabalpur 	HBG 		
Howrah 	HWH 	West Bengal 	Largest Station in India 	
Hubli Central Junction 	UBL 	Karnataka 	Headquarters of South Western Railway zone 	
Hugrajuli 	HJLI 		
Husainpur 	HSQ 		
Hyderabad DeccanNampally 	HYB 	Telangana 	
I
Station Name 	Station Code 	State 	Railway Zone 	Elevation 	Map
Ib 	IB 	Odisha 	
Ichapuram 	IGP 	Andhra Pradesh 	
Ichauli 	ICL 		
Idar 	IDAR 		
Idgah Agra Junction 	IDH 	Uttar Pradesh 	
Igatpuri 	IGP 	Maharashtra 	
Ikkar 	IKK 		
Iklehra 	IKR 		
Inchhapuri 	IHP 	Haryana 	
Indalvai 	IDL 		
Indapur 	INP 	Maharashtra 	KR / Konkan Railway 	20 m 	[89]
Indara Junction 	IAA 	Uttar Pradesh 	
Indargarh 	IDG 		
Indi Road 	IDR 		
Indore Junction (BG) 	INDB 	Madhya Pradesh 	
Indore Junction (MG) 	INDM 	Madhya Pradesh 	
Innanje 	INJ 		
Intikanne 			
Intiyathok 	ITE 		
Itehar 	AAH 	Madhya Pradesh 	
Iqbal Gadh 	IQG 		
Iqbalpur 	IQB 		
Irinjalakuda 	IJK 	Kerala 	
Irugur(Coimbatore) 	IGU 	Tamil Nadu 	
Isarda 	ISA 		
Islampur 	IPR 	Bihar 	
Ismaila Haryana 	ISM 	Haryana 	
Itarsi Junction 	ET 	Madhya Pradesh 	
Itola 	ITA 		
Itwari 	ITR 	Maharashtra 	
Izzatnagar 	IZN 	Uttar Pradesh 	
J
Joychandi Pahar railway station.
Station Name 	Station Code 	State 	Railway Zone 	Elevation 	Map
Jabalpur 	JBP 	Madhya Pradesh 	West central 	417m 	
Jabli 	JBL 			
Jabri 	JBX 			
Jadar 	JADR 			
Jadcherla 	JCL 	Telangana 		
Jagadhri 	JUD 	Haryana 		
Jagadhri Workshop 	JUDW 	Haryana 		
Jagadishpur 	JGD 			
Jagaddal 	JDL 	West Bengal 		
Jessore Road 	JSOR 	West Bengal 		
Jagatbela 	JTB 			
Jagdalpur 	JDB 	Chhattisgarh 	ECoR / East Coast 	
Jagdevwala 	JDL 			
Jagesharganj 	JGJ 			
Jagi road 	JID 	Assam 	NFR/Northeast Frontier 	62 m 	[90]
Jagnath Road Halt 	JNX 	Rajasthan 		
Jagraon 	JGN 	Punjab 		
Jahanikhera 	JKH 			
Jaipur 	JP 	Rajasthan 	North Western 	434m 	http://indiarailinfo.com/station/map/jaipur-junction-jp/272
Jais 	JAIS 	Uttar Pradesh 		
Jaisalmer 	JSM 	Rajasthan 	224m 	
Jaithari 	JTI 			
Jaitipur 	JTU 			
Jaitwar 	JTW 			
Jajiwal 	JWL 			
Jajpur Kheonjhar Road 	JJKR 	Odisha 		
Jakhal Junction 	JHL 	Haryana 		
Jakhalabandha 	JKB 	Assam 	NFR/Northeast Frontier 	73 m 	[91]
Jakhalaun 	JLN 			
Jakhania 	JKN 	Uttar Pradesh 		
Jakhaura 	JHA 			
Jakhim 	JHN 			
Jakhvada 	JKA 			
Jaksi 	JKS 			
Jalalganj 	JLL 			
Jalalpur Dhai 	JPD 			
Jalamb Junction 	JM 	Maharashtra 		
Jalandhar Cantonment 	JRC 	Punjab 		
Jalandhar City 	JUC 	Punjab 	238m 	
Jalesar Road 	JLS 	Uttar Pradesh 		
Jaleswar 	JER 	Odisha 	13m 	
Jalgaon Junction 	JL 	Maharashtra 	213m 	
Jalila Road 	JIL 			
Jaliya Devani 	JALD 			
Jalna 	J 	Maharashtra 		
Jalor 	JOR 	Rajasthan 		
Jalpaiguri 	JPG 	West Bengal 	84m 	
Jalpaiguri Road 	JPE 	West Bengal 		
Jalsu 	JAC 			
Jalsu Nanak 	JACN 			
Jam Jodhpur Junction 	JDH 	Rajesthan 		
Jam Wanthali 	WTJ 			
Jamalpur Junction 	JMP 	Bihar 	59m 	
Jambara 	JMV 			
Jambur 	JBB 			
Jamira 	JMRA 	Assam 	NFR/Northeast Frontier 	51 m 	[92]
Jammalamadugu 	JMDG 	Andhra Pradesh 		
Jammikunta 	JMKT 	Telangana 		
Jammu Tawi 	JAT 	Jammu & Kashmir 	336m 	
Jamnagar 	JAM 	Gujarat 		
Jamsar 	JMS 			
Jamtara 	JMT 	Jharkhand 	182m 	
Jamui 	JMU 	Bihar 	66m 	
Jamunamukh 	JMK 	Assam 	NFR/Northeast Frontier 	70 m 	[93]
Jamwala 	JVL 			
Janakpur Road 	JNR 	Bihar 	ECR 	
Jandiala 	JNL 			
Jangaon 	ZN 	Telangana 	380m 	
Janghai Junction 	JNH 	Uttar Pradesh 	92m 	
Jangipur Road 	JRLE 	West Bengal 	34m 	
Janiyana 	JNE 			
Jankampet Junction 	JKM 			
Jaora 	JAO 			
Japla 	JPL 			
Jarandeshwar 	JSV 			
Jargaon 	JRJ 			
Jari 	JARI 	Gujarat 		
Jaruda Naraa 				
Jarwal Road 	JLD 			
Jasia 	JSA 	Haryana 		
Jasali 	JSI 			
Jasidih Junction 	JSME 	Jharkhand 	271m 	
Jasra 	JSR 			
Jaswantgarh 	JSH 			
Jaswantnagar 	JGR 			
Jataula Samphka 	JSKA 	Haryana 		
Jath Road 	JTRD 			
Jatinga 	JTG 	Assam 	NFR/Northeast Frontier 	298 m 	[94]
Jatusana 	JTS 	Haryana 		
Jaulka 	JUK 			
Jaunpur City 	JOP 	Uttar Pradesh 		
Jaunpur Junction 	JNU 	Uttar Pradesh 		
Javale 	JVA 			
Jawad Road 	JWO 	Madhya Pradesh 		
Jawai Bandh 	JWB 			
Jawali 	JAL 	Rajasthan 		
Jawalamukhi Road 	JMKR 	Himachal Pradesh 	598m 	
Jayasingpur 	JSP 			
Jaynagar 	JYG 	Bihar 		
Jaynagar Majlipur 	JNM 			
Jehanabad 	JHD 	Bihat 		
Jejuri 	JJR 			
Jenal 	JNZ 	Gujarat 		
Jeonathpur 	JEP 			
Jetalsar Junction 	JLR 	Gujarat 		
Jetalvad 	JTV 			
Jetpur 	JTP 	Gujarat 		
Jeur 	JEUR 	Maharashtra 		
Jagannath Temple Gate 	JGE 	Odisha 		
Jhadupudi 	JPI 	Andhra Pradesh 		
Jhagadiya Junction 	JGI 			
Jhajha 	JAJ 	Bihar 	142m 	
Jhalawar Road 	JHW 	Rajasthan 		
Jhalida 	JAA 	West Bengal 		
Jhanjharpur 	JJP 	Bihar 		
Jhansi Junction 	JHS 	Uttar Pradesh 	North Central Railway 	
Jhansi Railway Station
Jhargram 	JGM 	West Bengal 		
Jharia 	JRI 	Jharkhand 		
Jharokhas 	JRQ 			
Jharsuguda Junction 	JSG 	Odisha 		
Jharwasaa 	JWS 			
Jhingura 	JHG 			
Jhinjhak 	JJK 	Uttar Pradesh 	NCR/North Central Railway 	131 m 	
Jhunjhunu 	JJN 	Rajasthan 		
Jhunpa 	JUP 			
Jigna 	JIA 			
Jind Junction 	JIND 	Haryana 		
Jira Road 	JIR 			
Jiradei 	ZRD 			
Jiribam 	JRBM 	Manipur 	NFR/Northeast Frontier 	46 m 	[95]
Jirighat 	JIGT 	Assam 	NFR/Northeast Frontier 	42 m 	[96]
Jiron 	JRO 			
Jiyapuram 	JPM 	Tamil Nadu 		
Jodhpur Junction 	JU 	Rajasthan 		
Jogbani 	JBN 	Bihar 		
Jogeshwari 	JOS 	Maharashtra 	WR/Western
Jogi Magra 	JOM 			
Jogidih 	JGF 			
Jogighopa 	JPZ 	Assam 	NFR/Northeast Frontier 	41 m 	[97]
Joginder Nagar 	JDNX 	Himachal Pradesh 		
Jogiwala 	JGW 			
Jolarpettai Junction 	JTJ 	Tamil Nadu 		
Jone Karrang 	JYK 			
Jorhat 	JT 	Assam 		
Jorhat Town 	JTTN 	Assam 		
Jotana 	JTN 			
Joychandi Pahar railway station 	JOC 	West Bengal 	JOC 	SER
Juchandra 		Maharashtra 	CR/Central
Jugijan 	JGJN 	Assam 	NFR/Northeast Frontier 	73 m 	[98]
Juinagar 		Maharashtra 	Harbour/Trans-Harbour (CR)
Jukehi 	JKE 			
Julana 	JNA 	Haryana 		
Junagadh C B 	JNDC 	Gujarat 		
Junagadh Junction 	JND 	Gujarat 	WR/Western 	86 m 	http://indiarailinfo.com/station/map/junagadh-junction-jnd/2125 	
Jung Bahadurganj 	JBG 			
Junichavand 	JCN 			
Junnor Deo 	JNO 			
Juriagaon 	JRX 	Assam 	NFR/Northeast Frontier 	68 m 	[99]
Jutogh 	JTO 	Himachal Pradesh 		
Jwalapur 	JWP 			
K
Station Name 	Station Code 	State 	Railway Zone 	Elevation 	Map
Kacheguda 	KCG 	Telangana 	SCR/South Central
Kachhwa Road 	KWH 				
Kadalundi 	KN 	Tamil Nadu 			
Kadambur 	KDU 	Tamil Nadu 			
Kadaynallur 	KDNL 	Tamil Nadu 			
Kadiri 	KRY 	Andhra Pradesh 			
Kadur Junction 	DRU 	Karnataka 	SWR/South Western Railway
Kaithalkuchi 	KTCH 	Assam 	NFR/Northeast Frontier 	50 m 	[100]
Kakinada Port 	COA 	Andhra Pradesh 			
Kakinada Town 	CCT 	Andhra Pradesh 			
Kankinara 	KNR 	West Bengal 			
Kalachand 	KQI 	Assam 	NFR/Northeast Frontier 	267 m 	[101]
Kalamboli 		Maharashtra 	CR/Central
Kalanaur kalan 	KLNK 	Haryana 			
Kalka 	KLK 	Haryana 	656m 		
Kalkalighat 	KKGT 	Assam 	NFR/Northeast Frontier 	31 m 	[102]
Kalwa 		Maharashtra 	CR/Central
Kalyan 	KYN 	Maharashtra 	CR/Central 		
Kalyani 	KLY 	West Bengal 			
Kalianpur(Kanpur) 	KAP 	Uttar Pradesh 			
Kalinarayanpur Junction 	KLNP 	West Bengal 			
Kalol Junction 	KLL 	Gujarat 			
Kamakhya Junction 	KYQ 	Assam 	NFR/Northeast Frontier 	55 m 	
Kaman Road 		Maharashtra 	CR/Central
Kamareddi 	KMC 	Telangana 			
Kampil Road 	KXF 	Uttar Pradesh
Kamshet 	KMST 	Maharashtra 			
Kamakhya Junction 	KYQ 	Assam 	NFR/Northeast Frontier 	55 m 	[103]
Kampur 	KWM 	Assam 	NFR/Northeast Frontier 	68 m 	[104]
Kamrup Khetri 	KKET 	Assam 	NFR/Northeast Frontier 	56 m 	[105]
Kanaibazar 	KNBR 	Assam 	NFR/Northeast Frontier 	27 m 	[106]
Kanchipuram 	CJ 	Tamil Nadu 			
Kandivali 	KILE 	Maharashtra 	WR/Western
Kangra 	KGRA 	Himachal Pradesh 			
Kanhangad 	KZE 	Kerala 			
Kanina Khas 	KNNK 	Haryana 			
Kaniyapuram 	KXP 	Kerala 			
Kanjiramittam 	KPTM 	Kerala 			
Kanjurmarg 		Maharashtra 	CR/Central
Kankanadi 	KNKD 	Karnataka 			
Kannauj 	KJN 	Uttar Pradesh 			
Kanpur Anwarganj 	CPA 	Uttar Pradesh 			
Kanpur City 	CNB 	Uttar Pradesh 			
Kanpur SMU CBSA CPSM 	CPSM 	Uttar Pradesh 			
Kanpur South(Govindpuri) 	GOY 	Uttar Pradesh 			
Kanpur Bridge Left Bank 	CPB 	Uttar Pradesh 			
Kanpur BGE L BK 	CPB 	Uttar Pradesh 			
Kanpur Central 	CNB 	Uttar Pradesh 			
Kanyakumari 	CAPE 	Tamil Nadu 			
Kapurthala 	KXH 	Punjab 			
Karad 	KRD 	Maharashtra 			
Karaikkudi Junction 	KKDI 	Tamil Nadu 			
Karanja 	KRJA 	Maharashtra 			
Karimganj Junction 	KXJ 	Assam 	NFR/Northeast Frontier 	23 m 	[107]
Karimnagar 	KRMR 	Telangana 	SCR/South Central
Karjat 	S 	Maharashtra 	CR/Central 		
Karnal 	KUN 	Haryana 	235 m 	NR / Northern 	
Karur Junction 	KRR 	Tamil Nadu 			
Karunagappalli 	KPY 	Kerala 	SR/Southern 		
Karwar 	KAWR 	Karnataka 			
Kasara 	N 	Maharashtra 	CR/Central
Kasaragod 	KGQ 	Kerala 			
Kashi 	KEI 	Uttar Pradesh 			
Katakhal Junction 	KTX 	Assam 	NFR/Northeast Frontier 	20 m 	[108]
Kathivakkam 	KAVM 	Tamil Nadu 	SR/Southern 	9 m 	
Katihar 	KIR 	Bihar 			
Katlicherra 	KLCR 	Assam 	NFR/Northeast Frontier 	45 m 	[109]
Katni 	KTE 	Madhya Pradesh 			
Katol 	KATL 	Maharashtra 			
Katpadi Junction, Vellore 	KPD 	Tamil Nadu 			
Katra 	KEA 	Uttar Pradesh 			
Kavali 	KVZ 	Andhra Pradesh 			
Kayamkulam 	KYJ 	Kerala 			
Kayasthagram 	KTGM 	Assam 	NFR/Northeast Frontier 	25 m 	[110]
Kazhakoottam TechnoPark Trivandrum 	KZK 	Kerala 			
Kazipet Junction 	KZJ 	Telangana 			
Kelavli 		Maharashtra 	CR/Central
Kelve Road 	KLV 	Maharashtra 	WR/Western
Kendukana 	KDKN 	Assam 	NFR/Northeast Frontier 	52 m 	[111]
Kesinga 	KSNG 	Odisha 	East Coast 		
Kesamudram 	KDM 	Telangana 	South Central Railway 		[112]
Khadavli 	KDV 	Maharashtra 	CR/Central
Khadki 	KK 	Maharashtra 			
Khairthal 	KRH 	Rajasthan 			
Khajuraho 	KURJ 	Madhya Pradesh 			
Khalilpur 	KIP 	Haryana 			
Khambhaliya 	KMBL 	Gujarat 			
Khamgaon 	KMN 	Maharashtra 			
Khamkhed 	KMN 	Maharashtra 			
Khammam 	KMT 	Telangana 	South Central Railway 		This is the Most Revenue Generated Station in the zone
Khana Junction 	KAN 	West Bengal 			
Khandala 	KAD 	Maharashtra 			
Khandeshwar 		Maharashtra 	Harbour (CR)
Khandwa 	KNW 	Madhya Pradesh 			
Khanna 	KNN 	Punjab 			
Kharagpur Junction 	KGP 	West Bengal 		1220 m 	That Is A Largest Platform Of India
Kharbao 		Maharashtra 	CR/Central
Khardi 	KE 	Maharashtra 	CR/Central
Kharghar 		Maharashtra 	Harbour (CR)
Khar Road 	KHAR 	Maharashtra 	WR/Western/Harbour (CR)
Khatauli 	KAT 	Uttar Pradesh 			
Khatu 	KHTU 	Rajasthan 			
Khed 	KHED 	Maharashtra 			
Khera Kalan 	KHKN 	Delhi 			
Khopoli 	KP 	Maharashtra 	CR/Central 		
Khurai 	KYE 	Madhya Pradesh 			
Kinwat 	KNVT 	Maharashtra 			
Kirloskarvadi 	KOV 	Maharashtra 			
Kirnahar 	KNHR 	West Bengal 			
Kilikolloor 		Kerala 			
King's Circle 		Maharashtra 	Harbour (CR)
Kishanganj 	KNE 	Bihar 	NFR 		
Kiul Junction 	KIUL 	Bihar 			
Kochuveli (Trivandrum /Thiruvananthapuram) 	KCVL 	Kerala 			
Kodaikanal road 	KQN 	Tamil Nadu 			
Koderma 	KQR 	Jharkhand 			
Kodinar 	KODR 	Gujarat 	WR/Western 	15 m 	[113]
Kodumudi 	KMD 	Tamil Nadu 			
Koduru 	KOU 	Andhra Pradesh 			
Kokrajhar 	KOJ 	Assam 	NFR/Northeast Frontier 	46 m 	[114]
Kolar 	KQZ 	Karnataka 			
Kollidam 	CLN 	Tamil Nadu 			
Kolhapur 	KOP 	Maharashtra 			
Kolad 	KOL 	Maharashtra 	KR / Konkan Railway 	17 m 	[115]
Kolkata Terminal 	KOAA 	West Bengal 			
Kollam Junction 	QLN 	Kerala 	SR/Southern 		
Konnagar 	KOG 	West Bengal 			
Kopar 		Maharashtra 	CR/Central
Kopargaon 	KPG 	Maharashtra 			
Kopar Khairane 		Maharashtra 	Trans-Harbour (CR)
Koraput Junction 	KRPU 	Odisha 	East Coast/ ECoR 		
Korattiangadi 		Kerala 			
Korattur 	KOTR 	Tamil Nadu 	SR/Southern 	12.85 m 	
Korba 	KRBA 	Chhattisgarh 			
Koregaon 	KRG 	Maharashtra 	CR/Central 		
Korukkupet 	KOK 	Tamil Nadu 	SR/Southern 	7 m 	
Kosamba 	KSB 	Gujarat 	
Kosi Kalan 	KSV 	Uttar Pradesh 			
Kosli 	KSI 	Haryana 			
Kotdwar 	KTW 	Uttarakhand 			
Kot Kapura 	KKP 	Punjab 			
Kota Junction 	KOTA 	Rajasthan 			
Kotli Kalan 	KTKL 	Punjab 			
Kotma 	KTMA 	Madhya Pradesh 	517m 		Map
Kotshila Junction 	KSX 	West Bengal 			
Kottapalli 	KYOP 	Telangana 			
Kottavalasa 	KTV 	Andhra Pradesh 			
Kottayam 	KTYM 	Kerala 			
Kottarakkara 	KTR 	kerala 			

   Kottikulam        KQK     Kerala

Kotturu 	KTY 	Andhra Pradesh 			
Kovilpatti 	CVP 	Tamil Nadu 			
Koyilandy 	QLD 	Kerala 			
Kozhikode 	CLT 	Kerala 			
Krishna Canal 	KCC 	Andhra Pradesh 			
Krishnai 	KRNI 	Assam 	NFR/Northeast Frontier 	44 m 	[116]
Krishnarajapuram 	KJM 	Karnataka 			
Kuchaman City 	KMNC 	Rajasthan 			
Kudal 	KUDL 	Maharashtra 	KR / Konkan Railway Corporation 	26 m 	
Kulitalai 	KLT 	Tamil Nadu 			
Kulpahar 	KLAR 	Uttar Pradesh 			
Kulti 	ULT 	West Bengal 			
Kumgaon Burti 	KJL 	Maharashtra 			
Kumbakonam 	KMU 	Tamil Nadu 			
Kumta 	KT 	Karnataka 	KRCL 		
Kundapura 	KUDA 	Karnataka 			
Kuppam 	KPN 	Andhra Pradesh 			
Kuram 	KUM 	Maharashtra 			
Kurichedu 	KCD 	Andhra Pradesh 			
Kurduvadi 	KWV 	Maharashtra 			
Kurla 	C/CH 	Maharashtra 	CR/Central/Harbour 		
Kurnool Town 	KRNT 	Andhra Pradesh 			
Kurukshetra Junction 	KKDE 	Haryana 			
Kuttippuram 	KTU 	Kerala 			
Kashipur 	KPV 	Uttarakhand 			
Khurda Road 	KUR 	Odisha 			
kursela 	KUE 	bihar 			
katihar 	KIR 	bihar 			
L
Station Name 	Station Code 	State 	Railway Zone 	Elevation 	Map
Laban 	LBN 		
Labha 	LAV 		
Labhpur 	LAB 	West Bengal 	
Lachhipura 	LAC 		
Lachhmangarh SK 	LNH 		
Lachhmanpur 	LMN 		
Lachyan 	LHN 		
Ladhowal 	LDW 	Punjab 	
Ladnun 	LAU 		
Laheria Sarai 	LSI 	Bihar 	
Lahli 	LHLL 	Haryana 	
Laimekuri 	LMY 		
Lakadiya 	LKZ 		
Lakheri 	LKE 		
Lakhimpur 	LMP 	Uttar Pradesh 	
Lakhminia 	LKN 		
Lakhnauria 	LNQ 		
Lakhtar 	LTR 		
Lakkidi 	LDY 	Kerala 	
Laksar Junction 	LRJ 	Uttarakhand 	
Lakshmibai Nagar 	LMNR 		
Lal Kuan 	LKU 	Uttarakhand 	
Lalabazar 	LLBR 	Assam 	NFR/Northeast Frontier 	32 m 	[117]
Lalapet 	LP 		
Lalganj 	LLJ 	Uttar Pradesh 	
Lalgarh Junction 	LGH 	Rajasthan 	
Lalgopalganj 	LGO 		
Lalgudi 	LLI 		
Lalitpur 	LAR 	Uttar Pradesh 	
Lalpur 	LLR 		
Lalpur Chandra 	LCN 		
Lalpur Jam 	LPJ 		
Lalpur Umri 	LRU 		
Lalru 	LLU 	Punjab 	
Lamana 	LNA 		
Lambhua 	LBA 		
Lambiya 	LMA 		
Lamsakhang 	LKG 	Assam 	NFR/Northeast Frontier 	106 m 	[118]
Landaura 	LDR 		
Langting 	LGT 	Assam 	NFR/Northeast Frontier 	147 m 	[119]
Lanka 	LKA 	Assam 	NFR/Northeast Frontier 	89 m 	[120]
Laopani 	LPN 	Assam 	NFR/Northeast Frontier 	63 m 	[121]
Lar Road 	LRD 		
Lasalgaon 	LS 	Maharashtra 	
Lasur 	LSR 		
Latehar 	LTHR 	Jharkhand 	
Lathi 	LAT 	Gujarat 	
Latur 	LUR 	Maharashtra 	CR/Central Railways 	622 m 	[122]
Latur Road 	LTRR 	Maharashtra 	SCR/South Central Railways 	650 m 	[123]
Laukaha Bazar 	LKQ 		
Laul 	LAUL 		
Lawa Sardargarh 	LSG 		
Ledarmer 	LDM 	Rajasthan 	
Lehra Gaga 	LHA 		
Lidhora Khurd 	LDA 		
Liliya Mota 	LMO 		
Limbdi 	LM 	Gujarat 	
Limkheda 	LMK 		
Linch 	LCH 		
Lingampalli 	LPI 	Telangana 	
Liluah 	LLH 		
Lodipur Bishnpr 	LDP 		
Loha 	LOHA 		
Loharu 	LHU 	Haryana 	
Loharwara 	LHW 		
Lohian Khas Junction 	LNK 	Punjab 	
Lohna Road 	LNO 	Bihar 	
Lohogad 	LHD 		
Loisingha 	LSX 	Odisha 	
Lokmanya Tilak Terminus 	LTT 	Maharashtra 	CR/Central
Lonand 	LNN 		
Lonavala 	LNL 	Maharashtra 	
Londa Junction 	LD 	Karnataka 	
Loni 	LONI 	Maharashtra 	
Lorwada 	LW 		
Lower Haflong 	LFG 	Assam 	NFR/Northeast Frontier 	479 m 	[124]
Lower Parel 	PL 	Maharashtra 	WR/Western
Lowjee 		Maharashtra 	CR/Central
Luckeesarai Junction 	LKR 	Bihar 	
Lucknow Junction 	LJN 	Uttar Pradesh 	
Lucknow 	LKO 	Uttar Pradesh 	
Lucknow City 	LC 	Uttar Pradesh 	
Ludhiana Junction 	LDH 	Punjab 	
Lumding Junction 	LMG 	Assam 	NFR/Northeast Frontier 	142 m 	[125]
Lunavada 	LNV 	Gujarat 	
Luni Junction 	LUNI 	Rajasthan 	
Luni Richha 	LNR 		
Lunidhar 	LDU 		
Lunkaransar 	LKS 	Rajasthan 	
Lusa 	LUSA 		
Lusadiya 	LSD 		
Lushala 	LAL 		
Lalgola 	LGL 	West Bengal 	ER 	
M
Mysore Railway Station
Station Name 	Station Code 	State 	Railway Zone 	Elevation 	Map
Macharya 	MCV 		
Machavaram 	AMIN 	Telangana 	
Machavaram 	MCVM 	Andhra Pradesh 	
Machelipatnam 	MTM 	Andhra Pradesh 	South Central Railway Zone 	
Macherla 	MCLA 	Andhra Pradesh 	
Madan Mahal 	MML 	Madhya Pradesh 	
Madanapalle Rd 	MPL 	Andhra Pradesh 	
Madanpur 	MDR 		
Maddur 	MAD 	Karnataka 	
Madhavnagar 	MDVR 	Maharashtra 	
Madukarai(Coimbatore) 	MDKI 	Tamil Nadu 	
Madurai 	MDU 	Tamil Nadu 	SR / Southern Railway 	139 m 	
Madgaon 	MAO 	Goa 	KR / Konkan Railway 	11 m 	
Mithlanchal Deep 	Madhubani 	Bihar 	
Madha 	MA 	Maharashtra 	
Madhabpur 	MDBP 		
Madhapar 	MDHP 		
Madhapur Road 	MADP 		
Madhi 	MID 		
Madhira 	MDR 	Telangana 	
Madhopur Punjab 	MDPB 	Punjab 	
Madhorajpur 	MQH 		
Madhosingh 	MBS 		
Madhubani 	MBI 	Bihar 	
Madhupur Junction 	MDP 	Jharkhand 	
Madurai Junction 	MDU 	Tamil Nadu 	
Madurantakam 	MMK 	Tamil Nadu 	
Madure 	MADR 		
Maghar 	MHH 		
Mahadanapuram 	MMH 		
Mahadevpara 	MHDP 		
Mahajan 	MHJ 		
Mahalam 	MFM 		
Mahalaxmi 	MX 	Maharashtra 	WR/Western
Mahamandir 	MMC 		
Mahansar 	MWR 		
Mahasamund 	MSMD 	Chhattisgarh 	
Mahbubabad 	MABD 	Telangana 	
Mahbubnagar 	MBNR 	Telangana 	
Mahe 	MAHE 	Mahe, Puducherry 	
Maheji 	MYJ 		
Mahendragarh 	MHRG 	Haryana 	
Mahes Khunt 	MSK 		
Mahesana Junction 	MSH 	Gujarat 	
Maheshmunda 	MMD 		
Mahidpur Road 	MEP 		
Mahim 	MM 	Maharashtra 	WR/Western/Harbour (CR)
Mahisgaon 	MGO 		
Mahmudabad Avdh 	MMB 	Uttar Pradesh 	
Mahmudpur SRYN 	MZN 		
Mahoba 	MBA 	Uttar Pradesh 	
Maholi 	MAHO 		
Mahpur 	MHO 		
Mahuamilan 	MMLN 		
Mahuariya 	MXY 		
Mahuda 	MHQ 		
Mahugarha 	MUGA 		
Mahur 	MXR 	Assam 	NFR/Northeast Frontier 	549 m 	[126]
Mahuva Junction 	MHV 	Gujarat 	
Maibang 	MBG 	Assam 	NFR/Northeast Frontier 	330 m 	[127]
Maihar 	MYR 	Madhya Pradesh 	
Maikalganj 	MINJ 		
Mailani 	MLN 	Uttar Pradesh 	
Mailongdisa 	MGX 	Assam 	NFR/Northeast Frontier 	290 m 	[128]
Mainpuri 	MNQ 	Uttar Pradesh 	
Mairabari 	MBO 	Assam 	NFR/Northeast Frontier 	64 m 	[129]
Mairwa 	MW 	Bihar 		Majri junction 	mjri 	
Majbat 	MJBT 		
Majgaon 	MZQ 	Assam 	NFR/Northeast Frontier 	51 m 	[130]
Majhagawan 	MJG 	Uttar Pradesh 	
Majhola Pakarya 	MJZ 		
Majorda 	MJO 	Goa 	
Makhu 	MXH 	Haryana 	
Makrana Junction 	MKN 	Rajasthan 	
Makrera 	MKRA 		
Makronia 	MKRN 	Madhya Pradesh 	
Maksi 	MKC 	Madhya Pradesh 	
Malad 	MDD 	Maharashtra 	WR/Western
Malarna 	MLZ 		
Malavli 	MVL 	Maharashtra 	CR
Malda Town 	MLDT 	West Bengal 	
Malerkotla 	MET 	Punjab 	
Malethu Kanak 	MEQ 		
Malhargarh 	MLG 		
Malhour 	ML 		
Malihabad 	MLD 		
Malipur 	MLPR 		
Maliya Hatina 	MLHA 		
Maliya Miyana 	MALB 	Gujarat 	
Malkapur 	MKU 	Maharashtra 	
Malkhaid Road 	MQR 	Maharashtra 	
Malkisar 	MLC 		
Mallanwala Khas 	MWX 		
Malleswaram 	MWM 		
Malliyam 	MY 		
Malout 	MOT 		
Malpura 	MLA 		
Malsailu 	MLSU 		
Malsian Shahkht 	MQS 		
Malugur 	MLU 		
Malur 	MLO 	Karnataka 	
Malwan 	MWH 	Uttar Pradesh 	
Malwara 	MBW 	Rajasthan 	
Maman 	MOM 		
Manaksar 	MNSR 		
Manamadurai Junction 	MNM 	Tamil Nadu 	
Mananpur 	MNP 		
Manaparai 	MPA 	Tamil Nadu 	
Manauri 	MRE 		
Manavadar 	MVR 		
Mancherial 	MCI 	Telangana 	
Mancheswar 	MCS 	Odisha 	
Manda Road 	MNF 		
Mandagere 	MGF 		
Mandal 	MDL 		
Mandalgarh 	MLGH 		
Mandapam 	MMM 	Tamilnadu 	
Mandapam Camp 	MC 		
Mandar Hill 	MDLE 	Bihar 	
Mandasa Road 	MMS 	Andhra Pradesh 	
Mandasor 	MDS 	Madhya Pradesh 	
Manderdisa 	MYD 	Assam 	NFR/Northeast Frontier 	216 m 	[131]
Mandhana Junction, Kanpur 	MDA 	Uttar Pradesh 	
Mandi Adampur 	ADR 	Haryana 	
Mandi Bamora 	MABA 	Madhya Pradesh 	
Mandi Dabwali 	MBY 	Haryana 	
Mandi Dhanaura 	MNDR 		
Mandi Dip 	MDDP 	Madhya Pradesh 	
Mandla Fort 	MFR 	Madhya Pradesh 	
Mandor 	MDB 	Rajasthan 	
Mandrak 	MXK 		
Manduadih 	MUV 	Uttar Pradesh 	
Mandya 	MYA 	Karnataka 	
Manendragarh 	MDGR 		
Mangalagiri 	MAG 	Andhra Pradesh 	
Mangaliyawas 	MLI 		
Mangalore Central 	MAQ 	Karnataka 	
Mangalore Junction 	MAJN 	Karnataka 	
Mangaon 	MNI 	Maharashtra 	KR / Konkan Railway 	12 m 	[132]
Mangliya Gaon 	MGG 	Madhya Pradesh 	
Mangolpuri 	MGLP 	Delhi 	
Mangra 	MAZ 		
Manheru 	MHU 		
Manigachi 	MGI 		
Manikpur Junction 	MKP 	Uttar Pradesh 	
Maninagar 	MAN 	Gujarat 	
Manipur Bagan 	MOAR 	Assam 	NFR/Northeast Frontier 	41 m 	[133]
Vanchi Maniyachchi Junction 	MEJ 	Tamilnadu 	
Manjeshwar 	MJS 		
Mankapur Junction 	MUR 	Uttar Pradesh 	
Mankar 	MNAE 		
Mankarai 	MNY 		
Mankatha 	MKB 		
Mankhurd 	M 	Maharashtra 	Harbour (CR)
Manki 	MANK 		
Manmad Junction 	MMR 	Maharashtra 	
Mannanur 	MNUR 		
Manoharganj 	MNJ 		
Manoharpur 	MOU 		
Mansa 	MSZ 	Punjab 	
Mansarovar 		Maharashtra 	Harbour (CR)
Mansi Junction 	MNE 	Bihar 	
Mansurpur 	MSP 		
Manthralayam Road 	MALM 	Andhra Pradesh 	
Manuguru 	MUGR 	Telangana 	
Manwath Road 	MVO 	Maharashtra 	
Manzurgarhi 	MZGI 		
Marahra 	MH 		
Maramjhiri 	MJY 		
Marauda 	MXA 		
Mariahu 	MAY 		
Mariani Junction 	MXN 	Assam 	NFR/Northeast Frontier 	
Marikuppam 	MKM 		
Marine Lines 	MEL 	Maharashtra 	WR/Western
Maripat 	MIU
Markapur Road 	MRK 	Andhra Pradesh 	
Markundi 	MKD 		
Marmagao 	MRH 		
Maroli 	MRL 	Gujarat 	
Marsul 	MRV 		
Marthipalayam 	MPLM 		
Marwar Bagra 	MBGA 	Rajasthan 	
Marwar Balia 	MBSK 	Rajasthan 	
Marwar Bhinmal 	MBNL 	Rajasthan 	
Marwar Birthi 	MBT 	Rajasthan 	
Marwar Chapri 	MCPE 	Rajasthan 	
Marwar Junction 	MJ 	Rajasthan 	
Marwar Kori 	KOF 	Rajasthan 	
Marwar Lohwat 	MWT 	Rajasthan 	
Marwar Mathanya 	MMY 	Rajasthan 	
Marwar Ratanpur 	MSQ 	Rajasthan 	
Masit 	MST 		
Masjid Bunder 	MSD 	Maharashtra 	CR/Central/Harbour
Maskanwa 	MSW 		
Masodha 	MSOD 		
Masrakh 	MHC 		
Masur 	MSR 		
Matana Buzurg 	MABG 		
Mataundh 	MTH 		
Mathura Cantonment 	MRT 	Uttar Pradesh 	
Mathura Junction 	MTJ 	Uttar Pradesh 	
Matlabpur 	MTB 		
Matmari 	MTU 		
Mattancheri Halt 	MTNC 		
Matunga 		Maharashtra 	CR/Central
Matunga Road 	MRU 	Maharashtra 	WR/Western
Mau Aimma 	MEM 	Uttar Pradesh 	
Mau Junction 	MAU 	Uttar Pradesh 	
Mau Ranipur 	MRPR 	Uttar Pradesh 	
Maur 	MAUR 	Punjab 	
Maval 	MAA 		
Mavelikara 	MVLK 	Kerala 	
Mavli Junction 	MVJ 	Rajasthan 	
Mayanoor 	MYU 	Tamil Nadu 	
Mayiladuturai Junction 	MV 	Tamil Nadu 	
McCluskieganj 	MGME 	Uttar Pradesh 	
Mecheda 	MCA 	West Bengal 	
Medchal 	MED 	Telangana 	
Meerut Cantonment 	MUT 	Uttar Pradesh 	
Meerut City 	MTC 	Uttar Pradesh 	
Meghnagar 	MGN 	Madhya Pradesh 	
Mehnar Road 	MNO 		
Mehsi 	MAI 		
Meja Road 	MJA 		
Melmaruvattur 	MLMR 		
Melusar 	MELH 		
Memari 	MYM 		
Meralgram 	MQX 		
Merta City 	MEC 	Rajasthan 	
Merta Road Junction 	MTD 	Rajasthan 	
Mettur 	MTE 	Tamil Nadu 	
Metupalaiyam 	MTP 	Tamil Nadu 	
Mettur Dam 	MTDM 	Tamil Nadu 	
Mhasavad 	MWD 	Maharashtra 	
Mahemdavad Kheda Road 	MHD 	Gujarat 	
Mhow 	MHOW 	Madhya Pradesh 	
Midnapore 	MDN 	West Bengal 	
Migrendisa 	MGE 	Assam 	NFR/Northeast Frontier 	484 m 	[134]
Mihinpurwa 	MIN 		
Mihrawan 	MIH 		
Milak 	MIL 		
Minjur 	MJR 	Tamil Nadu 	SR/Southern 	8 m 	
Miraj Junction 	MRJ 	Maharashtra 	
Miranpur Katra 	MK 		
Mira Road 	MIRA 	Maharashtra 	WR/Western
Mirchadhori 	MCQ 		
Mirhakur 	MIQ 		
Mirthal 	MRTL 	Punjab 	
Mirza 	MRZA 	Assam 	NFR/Northeast Frontier 	51 m 	[135]
Mirzapali 	MZL 		
Miryalaguda 	MRGA 	Telangana 	
Mirzapur 	MZP 	Uttar Pradesh 	
Misamari 	MSMI 		
Misrauli 	MFL 		
Mitha 	MITA 		
Mithapur 	MTHP 		
Miyagam Karjan 	MYG 	Gujarat 	
Miyana 	MYN 	Gujarat 	
Miyona ka Bara 	MNKB 	Rajasthan 	
Modelgram 	MG 		
Modinagar 	MDNR 	Uttar Pradesh 	
Modnimb 	MLB 		
Modpur 	MDPR 		
Modran 	MON 		
Moga 	MOGA 	Punjab 	
Mohammadkhera 	MQE 		
Mohanlalganj 	MLJ 	Uttar Pradesh 	
Mohiuddinnagar 	MOG 		
Mohiuddinpur 	MUZ 	Uttar Pradesh 	
Mohol 	MO 		
Mohri 	MOY 	Haryana 	
Mokalsar 	MKSR 	Rajasthan 	
Mokama Junction 	MKA 	Bihar 	
Mokholi 	MXL 		
Monabari 	MFC 		
Monacherra 	MNCR 	Assam 	NFR/Northeast Frontier 	25 m 	[136]
Mondh 	MOF 		
Munger 	MGR 	Bihar 	
Monglajhora 	MONJ 	Assam 	NFR/Northeast Frontier 	48 m 	[137]
Moore Market Complex (Chennai Central Suburban) 	MMC 	Tamil Nadu 	SR/Southern 		
Moradabad 	MB 	Uttar Pradesh 	
Morak 	MKX 		
Morappur 	MAP 	Tamil Nadu 	
Morbi 	MVI 	Gujarat 	
Mordar 	MRDD 		
Morena 	MRA 	Madhya Pradesh 	
Mori Bera 	MOI 		
Morinda 	MRND 	Punjab 	
Morthala 	MXO 		
Mota Jadra 	MQZ 		
Moterjhar 	MTJR 	Assam 	NFR/Northeast Frontier 	31 m 	[138]
Moth 	MOTH 	Uttar Pradesh 	
Mothala 	MTIA 		
Mothala Halt 	MTHH 		
Motichur 	MOTC 		
Bapudham Motihari 	BMKI 	Bihar 	
Motipur 	MTR 		
Motipura Chauki 	MTPC 		
Moula-Ali 	MOU 	Telangana 	
Muddanuru 	MOO 		
Mudkhed Junction 	MUE 	Maharashtra 	
Muftiganj 	MFJ 		
Mughal Sarai Junction 	MGS 	Uttar Pradesh 	
Muhammadabad 	MMA 		
Muirpur Road 	MPF 		
Mukerian 	MEX 	Punjab 	
Mukhtiar Balwar 	MKT 		
Muktsar 	MKS 	Punjab 	
Mukundarayapuram 	MCN 		
Muli Road 	MOL 		
Mulki 	MULK 		
Mullanpur 	MLX 	Punjab 	
Mulanur 			
Multai 	MTY 	Madhya Pradesh 	
Mulund 		Maharashtra 	CR/Central
Mumbai Central 	BCL 	Maharashtra 	WR/Western
Mumbra 		Maharashtra 	CR/Central
Munabao 	MBF 	Rajasthan 	
Mundalaram 	MDLM 		
Mundha Pande 	MPH 		
Mundhewadi 	MVE 		
Mungaoli 	MNV 		
Muniguda 	MNGD 	Odisha 	
Munirabad 	MRB 		
Munroturuttu 	MQO 	Kerala 	
Mupa 	MUPA 	Assam 	NFR/Northeast Frontier 	277 m 	[139]
Muradnagar 	MUD 	Uttar Pradesh 	
Murdeshwar 	MDRW 		
Murdeshwar 	MRDW 		
Muri 	MURI 	Jharkhand 	
Murkeongselek 	MZS 	Assam 	
Murliganj 	MRIJ 		
Murshadpur 	MSDR 		
Murshidabad 	MBB 	West Bengal 	
Murtizapur Junction 	MZR 	Maharashtra 	
Musafir Khana 	MFKA 	Uttar Pradesh 	
Mustafabad 	MFB 		
Muttarasanallur 	MTNL 		
Mutupet 	MTT 		
Muzaffarnagar 	MOZ 	Uttar Pradesh 	
Muzaffarpur Junction 	MFP 	Bihar 	ECR/East Central Railway 	57 m 	[140]
Muzzampur Narayan 	MZM 		
Mysore Junction 	MYS 	Karnataka 	
N
Nizamabad station during rain
Station Name 	Station Code 	State 	Railway Zone 	Elevation 	Map
Naya Ghaziabad 	GZN 	Uttar Pradesh 	
N J Ramanal 	NJM 		
Nabadwip Dham 	NDAE 	West Bengal 	
Nabha 	NBA 	Punjab 	
Nadauj 	NDU 		
Nadiad Junction 	ND 	Gujarat 	
Nandikoor 	NAND 	Karnatak 	KRCL 	
Nadikudi 	NDKD 	Telangana 	
Nagal 	NGL 		
Naganahalli 	NHY 		
Nagaon 	NGAN 	Assam 	NFR/Northeast Frontier 	68 m 	[141]
Nagappattinam 	NGT 	Tamil Nadu 	
Nagar 	NGE 	Rajasthan 	
Nagar Untari 	NUQ 	Jharkhand 	
Nagercoil Junction 	NCJ 	Tamil Nadu 	
Nagardevla 	NGD 		
Nagargali 	NAG 		
Nagari 	NGI 	Andhra Pradesh 	
Nagaria Sadat 	NRS 		
Nagarur 	NRR 		
Nagaur 	NGO 	Rajasthan 	
Nagbhir Junction 	NAB 	Maharashtra 	
Nagda Junction 	NAD 	Madhya Pradesh 	
Nagercoil Town 	NGK 	Tamilnadu 	
Nagina 	NGG 	Uttar Pradesh 	
Naglatula 	NGLT 		
Nagore 	NCR 	Tamil Nadu 	
Nagpur 	NGP 	Maharashtra 	
Nagrota 	NGRT 	Punjab 	
Naharkatiya 	NHK 		
Naharlagun 	NHLN 	Arunachal Pradesh 	NFR/North Frontier 	138 m 	[142]
Nahur 		Maharashtra 	CR/Central
Naigaon 	NIG 	Maharashtra 	WR/Western
Naihati Junction 	NH 	West Bengal 	
Naikheri 	NKI 		
Naila 	NIA 	Chhattisgarh 	SECR/South East Central 	294.40 m 	
Naini 	NYN 	Uttar Pradesh 	
Nainpur Junction 	NIR 	Madhya Pradesh 	
Najibabad Junction 	NBD 		
Nakodar Junction 	NRO 		
Nalanda 	NLD 	Bihar 	
Nala Sopara 	NSP 	Maharashtra 	WR/Western
Nalbari 	NLV 	Assam 	NFR/Northeast Frontier 	54 m 	[143]
Nalgonda 	NLDA 	Telangana 	
Nalhati 	NHT 	West Bengal 	
Naliya 	NLY 	Gujarat 	
Naliya Cantonment 	NLC 	Gujarat 	
Nalwar 	NW 		
Namakkal 	NMKL 	Tamil Nadu 	Southern Railways 	
Namburu 	NBR 		
Namkom 	NKM 	Jharkhand 	
Namli 	NLI 		
Namrup 	NAM 	Assam 	
Nana 	NANA 		
Nana Bhamodra 	NBHM 		
Nanaksar 	NNKR 		
Nandalur 	NRE 	Andhra Pradesh 	
Nandapur 	NDPR 		
Hazur Sahib Nanded 	NED 	Maharashtra 	
Nandganj 	NDJ 		
Nandgaon 	NGN 	Maharashtra 	
Nandgaon Road 	NAN 		
Nandiambakkam 	NPKM 	Tamil Nadu 	SR/Southern 	6 m 	
Nandol Dehegam 	NHM 		
Nandura 	NN 	Maharashtra 	
Nandurbar 	NDB 	Maharashtra 	
Nandyal 	NDL 	Andhra Pradesh 	
Nangal Dam 	NLDM 	Punjab 	
Nangloi 	NNO 	Delhi 	
Nanguneri 	NNN 	Tamil Nadu 	
Nanjangud Town 	NTW 	Karnataka 	
Nanpara Junction 	NNP 		
Naojan 	NJN 		
Napasar 	NPS 		
Nar Town 	NTN 		
Naraikkinar 	NRK 	Tamil Nadu 	SR/Southern 	50 m 	[144]
Naraina 	NRI 	Delhi 	
Narangi 	NNGE 	Assam 	NFR/Northeast Frontier 	54 m 	[145]
Naranjipur 	NRGR 		
Narasapur 	NS 	Andhra Pradesh 	
Narasaraopet 	NRT 	Andhra Pradesh 	
Narayanpet Road 	NRPD 		
Narayanpur 	NNR 	Assam 	
Narayanpur Anant 	NRPA 	Bihar 	ECR/ East Central Railway 	56m 	
Nardana 	NDN 		
Narela 	NUR 	Delhi 	
Nari Road 	NROD 		
Nariaoli 	NOI 		
Narkatiaganj Junction 	NKE 	Bihar 		68m 	
Narkher 	NRKR 	Maharashtra 	
Narnaul 	NNL 	Haryana 	
Naroda 	NRD 		
Narsinghpur 	NU 	Madhya Pradesh 	
Narwana Junction 	NRW 	Haryana 	
Narwasi 	NRWI 		
Nasik Road 	NK 	Maharashtra 	
Nasirabad 	NSD 		
Nathdwara 	NDT 		
Nathwana 	NTZ 		
Naugachia 	NNA 	Bihar 	
Nauganwan 	NGW 		
Naugarh 	NUH 	Uttar Pradesh 	
Naupada Junction 	NWP 	Andhra Pradesh 	
Nautanwa 	NTV 	Uttar Pradesh 	
Navade Road 		Maharashtra 	CR/Central
Navagadh 	NUD 		
Navalur 	NVU 		
Navapur 	NWU 	Gujarat 	
Navlakhi 	NLK 		
Navsari 	NVS 	Gujarat 	WR/Western 	14 m 	[146]
Nawa City 	NAC 		
Nawadah 	NWD 	Bihar 	
Nawagaon 	NVG 		
Nawalgarh 	NWH 	Rajasthan 	
Nawalgohan 	NVLN 		
Naya Azadpur 	NDAZ 	Delhi 	
Naya Kharadia 	NYK 		
Naya Nangal 	NNGL 	Punjab 	
Nayadupeta 	NYP 	Andhra Pradesh 	
Nayagaon 	NYO 		
Naydongri 	NI 		
Nazareth 	NZT 	Tamil Nadu 	
Nazirganj 	NAZJ 		
Nekonda 	NKD 	Telangana 	
Nellimaria 	NML 		
Nellore 	NLR 	Andhra Pradesh 	
Nemilichery 	NEC 	Tamil Nadu 	SR/Southern 	32.05 m 	
Nenpur 	NEP 		
Nepalganj Road 	NPR 	Uttar Pradesh 	
Nepanagar 	NPNR 	Madhya Pradesh 	
Neral 	NRL 	Maharashtra 	CR/Central
Nergundi 	NRG 		
Neri 	NERI 	Uttar Pradesh 	NR/Northern 	149 m 	[147]
Nerul 	NU 	Maharashtra 	Harbour/Trans-Harbour (CR)
Netawal 	NTWL 		
New Alipurduar 	NOQ 	West Bengal 	
New Bhuj 	NBUJ 	Gujarat 	
New Bhuj 	NBVJ 		
New Bongaigaon Junction 	NBQ 	Assam 	NFR/Northeast Frontier 	59 m 	[148]
New Cooch Behar 	NCB 	West Bengal 	
New Delhi 	NDLS 	Delhi NCT 	NR/Northern 	215 m 	[149]
New Farakka Junction 	NFK 	West Bengal 	
New Gitldada Junction 	NGTG 		
New Guntur 	NGNT 	Andhra Pradesh 	
New Jalpaiguri 	NJP 	West Bengal 	NFR 	
New Mal Junction 	NMZ 	West Bengal 	
New Maynaguri 	NMX 	West Bengal 	
New Misamari 	NMM 	Assam 	NFR/Northeast Frontier 	93 m 	[150]
Neyveli 	NVL 	Tamil Nadu 	
Neyyattinkara 	NYY 	Kerala 	SR/Southern 	11 m 	[151]
Ngrjunanagaramu 	NGJN 		
Nibhapur 	NBP 		
Nidadavolu Junction 	NDD 	Andhra Pradesh 	
Nidubrolu 	NDO 	Andhra Pradesh 	
Nigohan 	NHN 		
Nihalgarh 	NHH 	Uttar Pradesh 	
Nilaje 		Maharashtra 	CR/Central
Nilambazar 	NLBR 	Assam 	NFR/Northeast Frontier 	20 m 	[152]
Nilambur Road 	NIL 	Kerala 	
Nileshwar 	NLE 		
Nilokheri 	NLKR 	Haryana 	
Nim Ka Thana 	NMK 	Rajasthan 	
Nimach 	NMH 	Madhya Pradesh 	
Nimar Kheri 	NKR 		
Nimbahera 	NBH 		
Nimbhora 	NB 		
Nimtita 	NILE 	West Bengal 	
Nindhar Benar 	NDH 	Rajasthan 	
Ningala Junction 	NGA 		
Nipani Vadgaon 	NPW 		
Niphad 	NR 		
Nira 	NIRA 		
Nirakarpur 	NKP 	Odisha 	
Nirmali 	NMA 		
Nisui 	NSU 		
Nivari 	NEW 		
Nivasar 	NIV 		
Nizamabad 	NZB 	Telangana 	SCR/South Central Railway 	384 m 	
Nizampur 	NIP 		
Nizbarganj 	NBX 		
Nizchatia 	NCA 		
Noamundi 	NOMD 	Odisha 	
Nohar 	NHR 	Rajasthan 	
Nokha 	NOK 		
Nomoda 	NMD 		
Nonera 	NNE 		
Norla Road 	NRLR 	Odisha 	
North Lakhimpur 	NLP 	Assam 	
Nosaria 	NOA 		
Nowrozabad 	NRZB 		
Noyal 	NOY 		
Narayanpur Tatwar 	NNW 		
Nua 	NUA 		
Nunkhar 	NRA 		
Nurmahal 	NRM 		
O
Station Name 	Station Code 	State 	Railway Zone 	Elevation 	Map
Ongole 	OGL 	Andhra Pradesh 	SCR 	11m
Orai 	ORAI 	Uttar Pradesh 	North Central Railway 	
Railway Station Orai
Ottapalam 	OTP 	Kerala 	
Ooragaum 	OGM 	Karnataka 	
P
Station Name 	Station Code 	State 	Railway Zone 	Elevation 	Map
Pabai 	PAI 		
Pabli Khas 	PQY 	Uttar Pradesh 	
Pachrukhi 	PCK 		
Pachhapur 	PCH 		
Pachor Road 	PFR 		
Pachora Junction 	PC 	Maharashtra 	Central Railway
Padadhari 	PDH 		
Padhegaon 	PDGN 		
Padrauna 	POU 	Uttar Pradesh 	
Padse 	PDP 		
Padubidri 	PDD 	Karnataka 	
Pagara 	PGA 		
Pahara 	PRE 		
Paharpur 	PRP 		
Pajian 	PJA 		
Pakala Junction 	PAK 	Andhra Pradesh 	
Pakki 	PKK 		
Pakur 	PKR 	Jharkhand 	
Palachauri 	PCLI 		
Palam 	PM 	Delhi 	
Palampur Himachal 	PLMX 	Himachal Pradesh 	
Palampur HP OA 	PLMA 		
Palana 	PAE 		
Palani 	PLNI 	Tamil Nadu 	
Palanpur Junction 	PNU 	Gujarat 	
Palappuram 	PLPM 	Kerala 	
Palasa 	PSA 	Andhra Pradesh 	
Palasdari 		Maharashtra 	CR/Central
Paldhi 	PLD 		
Palej 	PLJ 		
Palghar 	PLG 	Maharashtra 	WR/Western
Palakkad Junction 	PGT 	Kerala 	
Palakkad Town 	PGTN 	Kerala 	
Palakollu 	PKO 	Andhra Pradesh 	South Central Railway 	1.9 m approx 	
Pali Marwar 	PMY 	Rajasthan 	
Palia 	PLA 		
Palia Kalan 	PLK 	Uttar Pradesh 	
Palitana 	PIT 	Gujarat 	
Palpara 	PXR 		
Palsana 	PLSN 		
Palsora Makrawa 	PSO 		
Palwal 	PWL 	Haryana 	
Pamban Junction 	PBM 	Tamil Nadu 	
Panagarh 	PAN 	West Bengal 	
Panbari 	PNB 	Assam 	NFR/Northeast Frontier 	53 m 	[153]
Panch Pipila 	PCN 	Madhya Pradesh 	
Panch Rukhi 	PHRH 		
Pancharatna 	PNVT 	Assam 	NFR/Northeast Frontier 	49 m 	[154]
Panchgram 	PNGM 	Assam 	NFR/Northeast Frontier 	28 m 	[155]
Panchtalavda Rd 	PCT 		
Pandavapura 	PANP 		
Pandaravadai 	PDV 	Tamil Nadu 	SR/Southern railway 	37m 	[156]
Pandharpur 	PVR 	Maharashtra 	
Pandhurna 	PAR 	Madhya Pradesh 	
Pandoli 	PMO 		
Paneli Moti 	PLM 		
Paniahwa 	PNYA 		
Panikhaiti 	PHI 	Assam 	NFR/Northeast Frontier 	55 m 	[157]
Panipat Junction 	PNP 	Haryana 	
Panitola 	PNT 		
Panjhan 	PJN 		
Panki, Kanpur 	PNK 	Uttar Pradesh 	NCR/North Central Railway 	
Panruti 	PRT 		
Panskura Junction 	PKU 	West Bengal 	
Pantnagar 	PBW 	Uttarakhand 	
Panvel 	PNVL 	Maharashtra 	CR/Central/Harbour
Papanasam 	PML 	Tamil Nadu 	
Paradgaon 	PDG 		
Paralakhemundi 	PLH 		Odisha 	
Paramakkudi 	PMK 	Tamil Nadu 	
Paras 	PS 		
Parasia 	PUX 		
Parasnath Station 	PNME 	Jharkhand 	East Central Railway 	228m 	[158]
Paravur 	PVU 	Kerala 	SR/Southern railway 	
Parbati 	PRB 		
Parbhani Junction 	PBN 	Maharashtra 	
Pardhande 	PHQ 		
Pardi 	PAD 		
Parel 		Maharashtra 	CR/Central
Parhihara 	PIH 		
Parkham 	PRK 		
Parli 	PLL 	Kerala 	
Parli Vaijnath 	PRLI 	Maharashtra 	
Parlu 	PRU 		
Parappanangadi 	PGI 	Kerala 	
Parsa Bazar 	PRBZ 		
Parsa Khera 	PKRA 		
Parsabad 	PSB 		
Parsipur 	PRF 		
Parsoda 	PSD 		
Partapgarh Junction 	PBH 		
Partapur, Uttar Pradesh 	PRTP 	Uttar Pradesh 	
Partur 	PTU 	Maharashtra 	
Parvatipuram 	PVP 	Andhra Pradesh 	
Parvatipuram Town 	PVPT 	Andhra Pradesh 	
Pasur 	PAS 		
Patal Pani 	PTP 		
Patan 	PTN 	Gujarat 	
Patara 	PTRE 		
Patas 	PAA 		
Pataudi Road 	PTRD 	Haryana 	
Pathankot Junction 	PTK 	Punjab 	
Pathankot Cantt 	PTKC 	Punjab 	
Pathardih Junction 	PEH 		
Patharkandi 	PTKD 	Assam 	NFR/Northeast Frontier 	27 m 	[159]
Patharkhola S 	PKB 	Assam 	NFR/Northeast Frontier 	124 m 	[160]
Patharia 	PHA 		
Pathauli 	PTLI 		
Pathri 	PRI 		
Pathsala 	PBL 	Assam 	NFR/Northeast Frontier 	47 m 	[161]
Patiala 	PTA 	Punjab 	
Patiladaha 	PTLD 	Assam 	NFR/Northeast Frontier 	49 m 	[162]
Patli 	PT 	Haryana 	
Patna Junction 	PNBE 	Bihar 	
Patna Saheb 	PNC 	Bihar 	
Patranga 	PTH 	Uttar Pradesh 	
Patratu 	PTRU 	Jharkhand 	
Patsul 	PTZ 		
Pattabiram 	PAB 	Tamil Nadu 	SR/Southern 	31 m 	
Pattabiram West 	PRWS 	Tamil Nadu 	SR/Southern 	40 m 	
Pattabiram East Depot 	PRES 	Tamil Nadu 	SR/Southern 	40 m 	
Pattambi 	PTB 	Kerala 	
Pattaravakkam 	PVM 	Tamil Nadu 	SR/Southern 	16.01 m 	
Patti 	PAX 		
Pavur Chatram 	PCM 		
Pawapuri Road 	PQE 		
Payagpur 	PDR 		
Payangadi 	PAZ 		
Payyanur 	PAY 		
Payyoli 	PYOL 	Kerala 	
Peddapalli 	PDPL 	Telangana 	
Pendra Road 	PND 	Chhattisgarh 	
Penganga 	PGG 	Maharashtra 	
Penukonda 	PKD 	Andhra Pradesh 	
Perambur 	PER 	Tamil Nadu 	SR/Southern 		
Perambur Carriage Works 	PCW 	Tamil Nadu 	SR/Southern 	7.16 m 	
Perambur Loco Works 	PEW 	Tamil Nadu 	SR/Southern 	7.01 m 	
Pernem 	PERN 	Goa 	
Perugamani 	PGN 		
Petlad Junction 	PTD 	Gujarat 	
Pethanaickenpalayam 	PDKM 	Tamil Nadu 	SR/Southern 	262.0 m 	
Pettaivayatalai 	PLI 		
Phagwara Junction 	PGW 	Punjab 	
Phakhoagram 	PKGM 	Assam 	NFR/Northeast Frontier 	36 m 	[163]
Phalodi 	PLC 	Rajasthan 	
Phanda 	PUD 		
Phaphamau Junction 	PFM 	Uttar Pradesh 	
Phaphund 	PHD 	Uttar Pradesh 	NCR/North Central Railway 	133 m 	
Phephna Junction 	PEP 	Rajasthan 	
Phesar 	PES 		
Phillaur Junction 	PHR 	Punjab 	
Phulad 	FLD 	Rajasthan 	
Phulaguri 	PUY 	Assam 	NFR/Northeast Frontier 	64 m 	[164]
Phulera Junction 	FL 	Rajasthan
Phulpur 	PLP 	Uttar Pradesh
Pij 	PIJ 		
Pilamedu(Coimbatore) 	PLMD 	Tamil Nadu 	
Pili Bangan 	PGK 	Rajasthan
Pilibhit Junction 	PBE 	Uttar Pradesh 	
Pilioda 	PDZ 		
Pilkhua 	PKW 	Uttar Pradesh 	
Pimpar Khed 	PKE 		
Pimpri 	PMP 	Maharashtra 	
Pindra Road 	PDRD 		
Pingleshwar 	PLW 		
Pipalda Road 	POR 	Rajasthan
Pipalsana 	PLS 	Uttar Pradesh 	
Pipar Road Junction 	PPR 	Rajasthan
Pipariya 	PPI 	Madhya Pradesh 	
Piparpur 	PPU 		
Piparsand 	POF 		
Piplaj 	PPF 		
Piplee 	PLE 		
Piplia 	PIP 	Madhya Pradesh 	
Piplod Junction 	PPD 	Gujarat 	
Piploda Bagla 	PPG 	Madhya Pradesh 	
Pipraich 	PPC 	Uttar Pradesh 	
Pipraigaon 	PIA 		
Piprala 	PFL 		
Pipri Dih 	PPH 		
Pirjhalar 	PJH 		
Pirpainti 	PPT 	Bihar 	
Pirthiganj 	PHV 		
Pirumadara 	PRM 		
Pirwa 	PW 		
Pitambarpur 	PMR 		
Pithapuram 	PAP 	Andhra Pradesh 	
Plassey 	PLY 	West Bengal 	
PMBAKVL_SHANDY 	PBKS 		
Podanur Junction 	PTJ 	Tamil Nadu 	
Pokhrayan 	PHN 	Uttar Pradesh 	North Central Railway 	
Pokhrayan Railway Station
Pokran 	POK 	Rajasthan 	
Pollachi Junction 	POY 	Tamil Nadu 	
Polur 	PRL 	Tamil Nadu 	
Ponmalai Golden Rock 	GOC 	Tamil Nadu 	
Ponneri 	PON 	Tamil Nadu 	
Porbandar 	PBR 	Gujarat 	
Potul 	POZ 		
Prachi Road Junction 	PCC 		
Pranpur Road 	PQD 	Uttar Pradesh 	
Prantij 	PRJ 	Gujarat
Prantik 	PNE 		
Prayag 	PRG 	Uttar Pradesh 	
Prayag Ghat 	PYG 		
Pritam Nagar 	PRNG 		
Proddatur 	PRDT 	Andhra Pradesh 	
Puducherry 	PDY 	Puducherry 	
Pudukad 	PUK 		
Pudukkottai 	PDKT 	Tamil Nadu 	SR/Southern 	90 m 	[165]
Pugalur 	PGR 		
Pulgaon Junction 	PLO 	Maharashtra 	
Punalur 	PUU 		
Punarakh 	PHK 		
Pundhag 	PNW 	Jharkhand 	
Pune Junction 	PUNE 	Maharashtra 	
Punkunnam 	PNQ 		
Punpun 	PPN 	Bihar 	
Puntamba 	PB 	Maharashtra 	
Purab Sarai 	PBS 		
Puraini 	PNI 		
Puranigudam 	PUQ 	Assam 	NFR/Northeast Frontier 	69 m 	[166]
Puranpur 	PP 	Uttar Pradesh 	
Puri 	PURI 	Odisha 	
Purna Junction 	PAU 	Maharashtra 	
Purnia Junction 	PRNA 	Bihar 	
Purnia Court 	PRNC 	Bihar 	
Purua Khera 	PRKE 		
Purulia Junction 	PRR 	West Bengal 	
Puttur 	PUT 	Andhra Pradesh 	
Q
Station Name 	Station Code 	State 	Railway Zone 	Elevation 	Map
Quarry SDG 	QRS 	SE Railway|
R
Station Name 	Station Code 	State 	Railway Zone 	Elevation 	Map
Rabale 		Maharashtra 	Trans-Harbour (CR)
Radhanpur 	RDHP 	Gujarat 	
Radhikapur 	RDP 	West Bengal 	
Rae Bareli Junction 	RBL 	Uttar Pradesh 	
Rafiganj 	RFJ 	Bihar 	
Ragaul 	RGU 		
Raghunathpur 	RPR 	Bihar 	
Raha 	RAHA 	Assam 	NFR/Northeast Frontier 	62 m 	[167]
Rahimabad, India 	RBD 		
Rahimatpur 	RMP 		
Rahul Road 	RRE 		
Rahuri 	RRI 	Maharashtra 	
Rai Singh Nagar 	RSNR 		
Raibha 	RAI 		
Raichur 	RC 	Karnataka 	
Raiganj 	RGJ 	West Bengal 	
Raigarh 	RIG 	Chhattisgarh 	
Raika Bagh 	RKB 	Rajasthan 	
Raila Road 	RLR 		
Raimehatpur 	MTPR 		
Raipur Junction 	R 	Chhattisgarh 	
Rairakhol 	RAIR 	Odisha 	
Raisi 	RSI 		
Raiwala 	RWL 	Uttarakhand 	
Raj Gangpur 	GP 	Odisha 	
Raj Nandgaon 	RJN 	Chhattisgarh 	
Raja Bhat Khawa 	RVK 		
Raja Ka Sahaspur 	RJK 	Uttar Pradesh 	
Raja Ki Mandi 	RKM 	Uttar Pradesh 	
Rajaldesar 	RJR 	Rajasthan 	
Rajamundry 	RJY 	Andhra Pradesh 	
Rajapalayam 	RJPM 	Tamil Nadu 	
Rajapur Road 	RAJP 	Maharashtra 	
Rajawari 	RJI 		
Rajendranagar Terminal 	RJQ 	Bihar 	
Rajgarh 	RHG 	Rajasthan 	
Rajghat Narora 	RG 	Uttar Pradesh 	
Rajgir 	RGD 	Bihar 	
Rajhura 	RHR 		
Rajiyasar 	RJS 		
Rajkharsawan Junction 	RKSN 	Jharkhand 	
Rajkot Junction 	RJT 	Gujarat 	
Rajlu Garhi 	RUG 		
Rajmahal 	RJL 	Jharkhand 	
Rajmane 	RM 		
Rajosi 	ROS 		
Rajpipla 	RAJ 	Gujarat 	
Rajpura Junction 	RPJ 	Punjab 	
Rajula City 	RJU 		
Rajula Junction 	RLA 		
Rajur 	RAJR 		
Rakha Mines 	RHE 		
Rakhi 	RHI 	Rajasthan 	
Ram Chaura Road 	RMC 		
Raman 	RMN 	Punjab 	
Ram Dayalu Nagar 	RD 	Muzaffarpur 	
Ramanagaram 	RMGM 	Karnataka 	
Ramanathapuram 	RMD 	Tamil Nadu 	
Ramdevra 	RDRA 	Rajasthan 	
Rameswaram 	RMM 	Tamil Nadu 	
Ramganga 	RGB 	Uttar Pradesh 	
Ramganj 	RMGJ 		
Ramganj Mandi 	RMA 	Rajasthan 	
Ramgarh Cantonment 	RMT 	Jharkhand 	
Ramgarhwa 	RGH 	Bihar 	
Ramagundam 	RDM 	Telangana 	
Ramkola 	RKL 		
Ramna 	RMF 		
Ramnagar 	RMR 	Uttarakhand 	
Rampur 	RMU 	Uttar Pradesh 	
Rampur Dumra 	RDUM 		
Rampur Hat 	RPH 	West Bengal 	
Rampura Phul 	PUL 		
Ramsan 	RXN 	Gujarat 	
Ramsar 	RMX 	Rajasthan 	
Ramtek 	RTK 	Maharashtra 	
Rana Bordi 	RNBD 		
Ranaghat Junction 	RHA 	West Bengal 	
Ranala 	RNL 		
Ranapratapnagar 	RPZ 	Rajasthan 	
Ranavav 	RWO 		
Marwar Ranawas 	MRWS 	Rajasthan 	
Ranchi 	RNC 	Jharkhand 	SER/SouthEastern 	632 m 	[168]
Ranchi Road 	RRME 	Jharkhand 	
Rangapara North 	RPAN 	Assam 	
Rangiya Junction 	RNY 	Assam 	NFR/Northeast Frontier 	53 m 	[169]
Rangjuli 	RGJI 	Assam 	NFR/Northeast Frontier 	50 m 	[170]
Rangmahal 	RMH 		
Rani 	RANI 	Rajasthan 	
Ranibennur 	RNR 	Karnataka 	
Raniganj 	RNG 	West Bengal 	
Ranipur Road 	RNRD 		
Raniwara 	RNV 	Rajasthan 	
Ranjangaon Rd 	RNJD 	Maharashtra 	
Ranjani 	RNE 		
Ranoli 	RNO 		
Ranolishishu 	RNIS 		
Ranpur 	RUR 		
Ranthambhore 	RNT 	Rajasthan 	
Ranuj 	RUJ 		
Rasra 	RSR 		
Rasulabad 	RUB 		
Rasull 	RES 		
Rasuriya 	RYS 		
Rasipuram 	RASP 	Tamil Nadu 	SR
Ratabari 	RTBR 	Assam 	NFR/Northeast Frontier 	38 m 	[33]
Ratan Shahr 	RSH 	Rajasthan 	
Ratangaon 	RTGN 		
Ratangarh Junction 	RTGH 	Rajasthan 	
Ratangarh West 	RXW 	Rajasthan 	
Ratanpura 	RTP 		
Rathdhana 	RDDE 	Haryana 	
Ratlam Junction 	RTM 	Madhya Pradesh 	
Ratnagiri 	RN 	Maharashtra 	KR / Konkan Railway 	129 m 	[171]
Ratnal 	RUT 		
Rau 	RAU 		
Rauzagaon 	RZN 		
Raver 	RV 	Maharashtra 	
Rawania Dungar 	RWJ 		
Rawatpur(Kanpur) 	RPO 	Uttar Pradesh 	
Raxaul Junction 	RXL 	Bihar 	
Rayagada 	RGDA 	Odisha 	
Rayalcheruvu 	RLO 	Andhra Pradesh 	
Raybag 	RBG 		
Razampeta 	RJP 		
Reay Road 		Maharashtra 	Harbour (CR)
Rechni Road 	RECH 		
Ren 	REN 		
Renigunta Junction 	RU 	Andhra Pradesh 	
Renukut 	RNQ 	Uttar Pradesh 	
Renwal 	RNW 		
Reoti B Khera 	RBK 		
Repalle 	RAL 	Andhra Pradesh 	
Rethorakalan 	RAKL 		
Rewa 	REWA 	Madhya Pradesh 	
Rewari Junction 	RE 	Haryana 	
Richha Road 	RR 		
Richughutu 	RCGT 		
Ridhore 	RID 		
Ringas Junction 	RGS 	Rajasthan 	
Risama 	RSA 		
Rishikesh 	RKSH 	Uttarakhand 	
Rishra 	RIS 	West Bengal 	
Risia 	RS 		
Rajendar Nagar Bihar 	RJPB 	Bihar 	
Ramgarh Shekhwati 	RSWT 	Rajasthan 	
Raninagar Jalpaiguri 	RQJ 	West Bengal 	
Robertsganj 	RBGJ 	Uttar Pradesh 	NCR
Roha 	ROH 	Maharashtra 	KR / Konkan Railway 	10 m 	[172]
Rohana Kalan 	RNA 	Uttar Pradesh 	
Rohini 	RHNE 	Maharashtra 	
Rohtak Junction 	ROK 	Haryana 	
Roorkee 	RK 	Uttarakhand 	
Rora 	RORA 		
Roshanpur 	RHN 		
Rotegaon 	RGO 		
Rourkela 	ROU 	Odisha 	
Rowta Bagan 	RWTB 		
Roza Junction 	RAC 	Uttar Pradesh 	
Rudauli 	RDL 		
Rudrapur City 	RUPC 	Uttarakhand 	
Rudrapur Road 	RUPR 		
Rukadi 	RKD 		
Runija 	RNJ 		
Runkhera 	RNH 		
Rupaheli 	RPI 		
Rupahigaon 	RUP 	Assam 	NFR/Northeast Frontier 	69 m 	[173]
Rupamau 	RUM 		
Rupasibari 	RPB 	Assam 	NFR/Northeast Frontier 	26 m 	[174]
Rupbas 	RBS 		
Rupnagar 	RPAR 	Punjab 	
Rupnarayanpur 	RNPR 		
Rupra Road 	RPRD 	Odisha 	
Rupsa Junction 	ROP 	Odisha 	
Rura 	RURA 	Uttar Pradesh 	NCR/North Central Railway 	
Rura Railway Station
	127 m 	
Rusera Ghat 	ROA 	Bihar 	
Ruthiyai Junction 	RTA 	Madhya Pradesh 	
S
Station Name 	Station Code 	State 	Railway Zone 	Elevation 	Map
S Narayan CHPLA 	SNC 	
Sabalgarh 	SBL 	Madhya Pradesh
Sabarmati Junction 	SBI 	
Sabarmati Junction 	SBT 	
Sabaur 	SBO 	
Sachin 	SCH 	Gujarat 	WR/Western Railway 	
Sadar Bazaar 	DSB 	Delhi
Sadat 	SDT 	
Sadhoo Garh 	SDY 	
Sadisopur 	SDE 	
Sadulpur Junction 	SDLP 	Rajasthan
Sadulshahr 	SDS 	Rajasthan
Safdarganj 	SGJ 	Uttar Pradesh
Safedabad 	SFH 	
Sagardighi 	SDI 	West Bengal
Sagar Jambagaru 	SRF 	
Sagarpali 	SVI 	
Sagauli Junction 	SGL 	Bihar
Sagoni 	SAO 	
Saharanpur Junction 	SRE 	Uttar Pradesh
Saharsa Junction 	SHC 	Bihar
Sahatwar 	STW 	
Sahawar Town 	SWRT 	
Sahibabad 	SBB 	
Sahibganj Junction 	SBG 	Jharkhand
Sahibpur KML Junction 	SKJ 	
Sahjanwa 	SWA 	
Sri Sathya Sai Prasanthi Nilayam 	SSPN 	Andhra Pradesh
Saidkhanpur 	SYK 	
Saidraja 	SYJ 	
Sainthia 	SNT 	West Bengal
Saiyid Sarawan 	SYWN 	
Sajanvar Road 	SJF 	
Sajiyavadar 	SVJ 	
Sakaldiha 	SLD 	
Sakharayapatna (Sakrepatna) 	SKPN 	Karnataka 	South Western Railway
Sakhi Gopal 	SIL 	Odisha
Sakhoti Tanda 	SKF 	
Sakhpur 	SKR 	
Sakleshpur 	SKLR 	Karnataka
Sakri Junction 	SKI 	
Saktesgarh 	SKGH 	
Sakti 	SKT 	Chhattisgarh
Salakati 	SLKX 	Assam 	NFR/Northeast Frontier 	49 m 	[175]
Salamatpur 	SMT 	
Salar 	SALE 	
Salarpur 	SLRP 	
Salawas 	SZ 	Rajasthan
Salchapra 	SCA 	Assam 	NFR/Northeast Frontier 	21 m 	[176]
Salekasa 	SKS 	Maharashtra
Salem Junction 	SA 		SR/ Southern Railway 	283 m 	
Salem Market 	SAMT 	Tamilnadu
Salem Town 	SXT 	
Salemgarhmasani 	SJSM 	
Salempur Junction 	SRU 	Uttar Pradesh
Salogra 	SLR 	
Salona 	SLON 	Assam 	NFR/Northeast Frontier 	83 m 	[177]
Salpura 	SYL 	
Salur 	SALR 	Andhra Pradesh
Salwa 	SAL 	
Samaguri 	SMGR 	Assam 	NFR/Northeast Frontier 	70 m 	[178]
Samakhiali 	SIO 	
Samakhiali B G 	SIOB 	Gujarat
Samalkha 	SMK 	Haryana
Samalpatti 	SLY 	Tamil Nadu
Samalkot Junction 	SLO 	Andhra Pradesh
Samastipur Junction 	SPJ 	Bihar 	ECR/East Central Railway 	43 m 	
Samba 	SMBX 	Jammu And Kashmir
Sambalpur 	SBP 	Odisha
Sambalpur Road 	SBPD 	
Sambhar Lake 	SBR 	Rajasthan
Samdhari Junction 	SMR 	Rajasthan
Samlaya Junction 	SMLA 	
Sampla 	SPZ 	Haryana
Samrau 	SRK 	
Samsi 	SM 	
Sanehwal 	SNL 	Punjab
Sanand 	SAU 	Gujarat
Sanaura 	SWU 	
Sanawad 	SWD 	
Sanchi 	SCI 	Madhya Pradesh
Sandal Kalan 	SLKN 	
Sandila 	SAN 	
Sanathnagar 	SNF 	
Sandhurst Road 	SNRD 	Maharashtra 	CR/Central/Harbour
Saneh Road 	SNX 	
Sanganapur 	SNGR 	
Sanganer 	SNGN 	
Sangar 	SGRR 	
Sangaria 	SGRA 	
Sangat 	SGF 	
Sangli 	SLI 	Maharashtra
Sangmeshwar Road 	SGR 	Maharashtra 	KR / Konkan Railway 	37 m 	[179]
Sangola 	SGLA 	
Sangrampur 	SNU 	
Sangrana Sahib 	SBS 	
Sangrur 	SAG 	Punjab
Sanichara 	SAC 	
Sanjan 	SJN 	
Sankarankovil 	SNKL 	Tamil Nadu
SankariDurg 	SGE 	Tamil Nadu
Sankval 	SKVL 	
Sanosara Nandra 	SNSR 	
Sanosra 	SOA 	
Sanpada 		Maharashtra 	Harbour/Trans-Harbour (CR)
Sant Road 	SAT 	
Santacruz 	STC 	Maharashtra 	WR/Western/Harbour (CR)
Santaldih 	SNTD 	
Santalpur 	SNLR 	
Sanvordam Curchorem 	DCR 	Goa
Sanvatsar 	SNVR 	
Sanvrad 	SVO 	
Sapatgram 	SPX 	Assam 	NFR/Northeast Frontier 	45 m 	[180]
Saphale 	SAH 	Maharashtra 	WR/Western
Saradhna 	SDH 	
Sarai Chandi 	SYC 	
Sarai Harkhu 	SVZ 	
Sarai Kansrai 	SQN 	
Sarai Mir 	SMZ 	
Sarai Rani 	RKS 	
Sarangpur 	SFW 	
Sardarnagar 	SANR 	
Sardarshahr 	SRDR 	
Sareigram 	SGAM 	
Sareri 	SSR 	
Sarkoni 	SIQ 	
Sarnath 	SRNT 	
Sarojini Nagar 	SOJ 	
Sarola 	SRL 	
Sarotra Road 	SZA 	
Sarsawa 	SSW 	
Sarupathar 	SZR 	
Sarwari 	SVD 	
Sasan Gir 	SASG 	
Sasaram 	SSM 	Bihar
Sasni 	SNS 	
Satadhar 	STDR 	
Satara 	STR 	Maharashtra
Sathajagat 	STJT 	
Sathiaon 	SAA 	
Sathin Road 	SWF 	
Satna 	STA 	Madhya Pradesh
Satnali 	STNL 	
Satuna 	SCO 	
Satur 	SRT 	Tamil Nadu
Saugor 	SGO 	
Savarda 	SVX 	
Savarkundla 	SVKD 	
Savda 	SAV 	
Sawai Madhopur 	SWM 	Rajasthan
Sawai Madhopur Junction 	SWMM 	
Sawantwadi Road 	SWV 	Maharashtra
Sealdah 	SDAH 	West Bengal
Seawoods-Darave 		Maharashtra 	Harbour (CR)
Secunderabad Junction 	SC 	Telangana
Sehore 	SEH 	Madhya Pradesh
Sehramau 	SW 	
Selu 	SELU 	Maharashtra
Semarkheri 	SRKI 	
Senapura 	SEN 	
Senchoa Junction 	SCE 	Assam 	NFR/Northeast Frontier 	63 m 	[181]
Sendra 	SEU 	
Sengottai 	SCT 	Tamil Nadu
Seohara 	SEO 	
Seoraphuli 	SHE 	
Seram 	SEM 	Karnataka
Serampore 	SRP 	
Settihally 	SET 	
Sevagram 	SEGM 	Maharashtra
Sevaliya 	SVL 	
Sewapuri 	SWPR 	
Sewri 		Maharashtra 	Harbour (CR)
Shadhoragaon 	SHDR 	
Shahabad 	SDB 	Karnataka
Shahad 	SHAD 	Maharashtra 	CR/Central
Saharsa Junction 	SHS 	Bihar
Shahbad Markanda 	SHDM 	Haryana
Shahbad Mohammadpur 		
Shahdol 	SDL 	Madhya Pradesh
Shahganj Junction 	SHG 	Uttar Pradesh
Shahjehanpur 	SPN 	Uttar Pradesh
Shahpur Patoree 	SPP 	Bihar
Shahzad Nagar 	SAR 	
Shajahanpur court 	SXK 	Uttar Pradesh
Shajapur 	SFY 	Madhya Pradesh
Shakti Nagar 	SKTN 	Uttar Pradesh
Shakurbasti 	SSB 	Delhi
Shambhupura 	SMP 	
Shamgarh 	SGZ 	Madhya Pradesh
Shamlaji Road 	SJS 	
Shankargarh 	SRJ 	
Shankarpalli 	SKP 	Telangana
Shantipur 	STB 	
Shapur Sorath Junction 	SHH 	
Sharma 	SHRM 	
SHDSPRA_PADMPRA 	SAS 	
Shedbal 	SED 	
Shegaon 	SEG 	Maharashtra
Sheikpura 	SHK 	
Shelu 		Maharashtra 	CR/Central
Shendri 	SEI 	
Shenoli 	SNE 	
Sheo Singh Pura 	SHNX 	
Sheopur Kalan 	SOE 	Madhya Pradesh
Sherekan 	SRKN 	
Shertalai 	SRTL 	
Shikohabad Junction 	SKB 	Uttar Pradesh
Shimoga 	SME 	Karnataka
Shimoga Town 	SMET 	
Shirdi (Sainagar Shirdi) 	SNSI 	Maharashtra
Shiribagilu 		
Shiroor 	SHMI 	
Shirravde 	SIW 	
Shirsoli 	SS 	
Shiupur 	SOP 	
Shivamogga 		Karnataka
Shivarampur 	WSC 	
Shivnagar 	SHNG 	
Shivni Shivapur 	SVW 	Maharashtra
Shivpuri 	SVPI 	Madhya Pradesh
Shivrampur 	SWC 	
Shivaji Bridge 	CSB 	Delhi
Shoghi 	SGS 	
Shohratgarh 	SOT 	
Sholapur CB 	SURC 	Maharashtra
Sholavandan 	SDN 	Tamil Nadu
Shoranur Junction 	SRR 	Kerala
Shri Amirgadh 	SIM 	Gujarat
Shri Ganganagar 	SGNR 	Rajasthan
Shri Karanpur 	SRW 	
Shri Madhopur 	SMPR 	
Shri Mahabirji 	SMBJ 	Rajasthan
Shri Mata Vaishno Devi Katra 	SVDK 	Jammu and Kashmir
Shridham 	SRID 	Madhya Pradesh
Shrigonda Road 	SGND 	Maharashtra
Shrikalyanpura 	SKPA 	
ShriKshetra Nagzari 	NGZ 	Maharashtra
Shrirajnagar 	SAGR 	
Shrirangapatna 	S 	Karnataka
Shrivagilu 	SVGL 	
Shujaatpur 	SJT 	
Shujalpur 	SJP 	
Shyamnagar 	SNR 	West Bengal
Siajuli 	SWJ 	
Sibsagar Town (Sivasagar) 	SRTN 	Assam
Siddhpur 	SID 	Gujarat
Sidhauli 	SD 	
Sidmukh 	SDMK 	
Sihapar 	SIPR 	
Siho 	SIHO 	
Sihor Gujarat 	SOJN 	Gujarat
Sihora Road 	SHR 	
Sikandarpur 	SKQ 	
Sikandra Rao 	SKA 	
Sikar Junction 	SIKR 	Rajasthan
Sikir 	SFK 	
Silanibari 	SOB 	
Silao 	SILO 	
Silapathar 	SPTR 	
Silaut 	SLT 	
Silchar 	SCL 	Assam 	NFR/Northeast Frontier 	26 m 	[182]
Silghat Town 	SHTT 	Assam 	NFR/Northeast Frontier 	76 m 	[183]
Siliguri Junction 	SGUJ 	West Bengal
Siliguru Town 	SGUT 	
Silli 	SLF 	Jharkhand
Simaluguri Junction 	SLGR 	Assam
Simaria 	SAE 	
Simbhooli 	SMBL 	
Simen Chapari 	SMCP 	
Simhachalam 	SCM 	Andhra Pradesh
Simla 	SML 	Himachal Pradesh
Simlagarh 	SLG 	
Simultala 	STL 	
Simurali 	SMX 	
Sindhudurg 	SNDD 	Maharashtra
Sindi 	SNI 	Maharashtra
Sindkheda 	SNK 	Maharashtra
Sindpan 	SDPN 	
Sindri Town 	SNDT 	
Sindurwa 	SYW 	
Singanallur(Coimbatore) 	SHIN 	Tamil Nadu
Singapur Road 	SPRD 	Andhra Pradesh
Singarayakonda 	SKM 	Andhra Pradesh
Singareni Colleries 	SYI 	Telangana
Singarpur 	SNPR 	
Singrauli 	SGRL 	Madhya Pradesh
Singwal 	SGW 	
Sini Junction 	SINI 	Jharkhand
Sion 		Maharashtra 	CR/Central
Siras 	SRAS 	
Sirathu 	SRO 	
Sirhind Junction 	SIR 	Punjab
Sirkazhi 	SY 	Tamil Nadu
Sirli 	SIF 	
Sirohi Road 	SOH 	
Sirpur Kagaznagar 	SKZR 	Telangana
Sirpur Town 	SRUR 	Telangana
Sirran 	SIRN 	
Sirsa 	SSA 	Haryana
Sisarka 	SSKA 	
Sisvinhalli 	SVHE 	
Siswa Bazar 	SBZ 	
Sitamarhi 	SMI 	Bihar
Sitapur 	STP 	Uttar Pradesh
Sitapur Cantonment 	SCC 	
Sitapur City 	SPC 	
Sitarampur 	STN 	
Sithalavai 	SEV 	
Sithouli 	STLI 	
Sitimani 	SII 	
Sivaganga 	SVGA 	Tamil Nadu
Sivajinagar 	SVJR 	
Sivakasi 	SVKS 	Tamil Nadu
Siwaith 	SWE 	
Siwan Junction 	SV 	Bihar
Siwani 	SWNI 	Haryana
Sodepur 	SDP 	West Bengal
Sohagpur 	SGP 	Madhya Pradesh
Sohwal 	SLW 	
Sojat Road 	SOD 	Rajasthan
Sojitra 	SJTR 	
Solan 	SOL 	Himachal Pradesh
Solan Brewery 	SBY 	
Solapur Junction 	SUR 	Maharashtra
Solapur Junction 	SURM 	Maharashtra
Somanur 	SNO 	Tamil Nadu
Somesar 	SOS 	
Somna 	SOM 	
Somnath 	SMNH 	Gujarat
Sompeta 	SPT 	Andhra Pradesh
Son Nagar 	SEB 	Bihar
Sonagir 	SOR 	
Sonarpur Junction 	SPR 	West Bengal
Sondha Road 	SCN 	
Sonegaon 	SNN 	
Songadh 	SGD 	
Soni 	SONI 	
Sonik 	SIC 	
Sonipat 	SNP 	Haryana
Sonpur Junction 	SEE 	Bihar
Sonwara 	SWO 	
Sorbhog Junction 	SBE 	Assam 	NFR/Northeast Frontier 	52 m 	[184]
Sorupeta 	SPQ 	Assam 	NFR/Northeast Frontier 	47 m 	[185]
Soro 	SORO 	Odisha
Soron 	SRN 	
Sri Dungargarh 	SDGH 	Rajasthan
Sri Kalahasti 	KHT 	Andhra Pradesh
Srikakulam Road 	CHE 	Andhra Pradesh
Srikrishna Nagar 	SKN 	
Sriramnagar 	SRNR 	Andhra Pradesh
Srirampur, Assam 	SRPB 	Assam 	NFR/Northeast Frontier 	50 m 	[186]
Srirangam 	SRGM 	Tamil Nadu
Srivilliputtur 	SVPR 	Tamil Nadu
Subansiri 	SUZ 	
Subedarganj 	SFG 	
Subrahmanya Road 	SBHR 	Karnataka
Subzi Mandi 	SZM 	Delhi
Suchipind 	SCPD 	
Sudsar 	SDF 	
Sujangarh 	SUJH 	
Sujanpur 	SJNP 	
Sukhisewaniyan 	SUW 	
Sukhpar Roha 	SRHA 	
Sukhpur 	SUKP 	
Sukritipur 	SQF 	Assam 	NFR/Northeast Frontier 	24 m 	[187]
Suladhal 	SUL 	
Sulah Himachal Pradesh 	SLHP 	Himachal Pradesh
Sulgare 	SGRE 	
Sullurupeta 	SPE 	Andhra Pradesh
Sultanganj 	SGG 	
Sultanpur 	SLN 	
Sultanpur Lodi 	SQR 	
Sulur Road (Coimbatore) 	SUU 	Tamil Nadu
Sumer 	SUMR 	
Summadevi 	SUDV 	
Summer Hill 	SHZ 	
Sumreri 	SMRR 	
Sunam 	SFM 	Punjab
SundaraperumalKoil 	SPL 	Tamil Nadu
Sunderabad 	SNBD 	
Sundlak 	SDLK 	
Supaul 	SOU 	Bihar
Suraimanpur 	SIP 	
Surajgarh 	SRGH 	
Surajpur 	SUPR 	Chhattisgarh
Surajpur Road 	SJQ 	
Surat 	ST 	Gujarat 	WR/Western Railway 	
Suratgarh Junction 	SOG 	Rajasthan
Surathkal 	SL 	Karnataka 	Konkan Railway 	
Suravali 	SRVX 	
Sureli 	SURL 	
Surendranagar 	SUNR 	Gujarat
Suriawan 	SAW 	
Surla Road 	SLRD 	Odisha
Surpura 	SPO 	
Suwansa 	SWS 	
Suwasra 	SVA 	
Swamimalai 	SWI 	Tamil Nadu
Swarupganj 	SRPJ 	
T
Station Name 	Station Code 	State 	Railway Zone 	Elevation 	Map
Tadali 	TAE 	Maharashtra 			
Tadepalligudem 	TDD 	Andhra Pradesh 			
Tadipatri 	TU 	Andhra Pradesh 			
Tadwal 	TVL 				
Tahsil Bhadra 	TSD 				
Tahsil Fatehpur 	TSF 				
Tajpur 	TJP 				
Tajpur Dehma 	TJD 				
Tamluk 	TMZ 	West Bengal 			
Tamuriya 	Madhubani 	Bihar 			
Takal 	TAKL 				
Takari 	TKR 				
Takarkhede 	TKHE 				
Takia 	TQA 				
Taksal 	TSL 				
Taku 	TAKU 				
Talaiyuthu 	TAY 				
Talaja 	TJA 				
Talakhajuri 	TLKH 				
Talala Junction 	TAV 	Gujarat 			
Talavli 	TLZ 				
Talbahat 	TBT 	Uttar Pradesh 			
Talcher 	TLHR 	Odisha 			
Talchhapar 	TLC 				
Talegaon Dabhade 	TGN 				
Talguppa 	TLGP 	Karnataka 			
Talheri Buzurg 	THJ 				
Talli Saidasahu 	TSS 				
Talod 	TOD 				
Taloja 		Maharashtra 	CR/Central
Talwandi 	TWB 	Punjab 			
Tambaram 	TBM 	Tamil Nadu 			
Tamkuhi Road 	TOI 			
Tanakpur 	TPU 	Uttarakhand 			
Tanda Urmar 	TDO 				
Tandur 	TDU 	Telangana 			
Tangla 	TNL 				
Tangra 	TRA 	West Bengal 			
Tankuppa 	TKN 				
Tanuku 	TNKU 	Andhra Pradesh 			
Tanur 	TA 	Kerala 			
Tapa 	TAPA 	Punjab 			
Tapri 	TPZ 	Uttar Pradesh 			
Tarabari 	TRBE 	Assam 	NFR/Northeast Frontier 	69 m 	[188]
Taradevi 	TVI 				
Tarak Nagar 	TNX 				
Tarana Road 	TAN 				
Taranga Hill 	TRAH 				
Taraori 	TRR 	Haryana 			
Taregna 	TEA 				
Targaon 	TAZ 				
Tarighat 	TRG 				
Tarlupadu 	TRL 				
Tarn Taran 	TTO 	Punjab 			
Tarsai 	TRSR 				
Tarsari Muria 	TRSR 				
Tatanagar Junction 	TATA 	Jharkhand 			
Tatibahar 	TBH 				
Tatisilwai 	TIS 	Jharkhand 			
Teghra 	TGA 				
Teharka 	TKA 				
Telam 	TQM 				
Tellicherry 	TLY 	Kerala 			
Tenali Junction 	TEL 	Andhra Pradesh 			
Theni 	TENI 	Tamil Nadu 			
Tenkasi 	TSI 	Tamil Nadu 			
Tenmalai 	TML 	Tamil Nadu 			
Tetelia 	TTLA 	Assam 	NFR/Northeast Frontier 	57 m 	[189]
Tetulmari 	TET 				
Tezpore 	TZTB 	Assam 			
Thakurkuchi 	TKC 	Assam 	NFR/Northeast Frontier 	80 m 	[190]
Thakurli 		Maharashtra 	CR/Central
Than Junction 	THAN 	Gujarat 			
Thana Bihpur Junction 	THB 	Bihar 			
Thandla Rd 	THDR 	Madhya Pradesh 			
Thane 	TNA 	Maharashtra 	CR/Central/Trans-Harbour 		
Thanjavur 	TJ 	Tamil Nadu 			
Thathana Mithri 	THMR 				
Thawe Junction 	THE 	Maharashtra 			
Thekeraguri 	TGE 	Assam 	NFR/Northeast Frontier 	64 m 	[191]
Therubali 	THV 	Odisha 			
Thrissur 	TCR 	Kerala 		
Trivandrum Central 	TVC 	Kerala 			[192]
Thirumullaivoyal 	TMVL 	Tamil Nadu 	SR/Southern 	21.73 m 	
Thiruninravur 	TI 	Tamil Nadu 	SR/Southern 	37 m 	
Thiruvananthapuram Pettah 	TVP 	Kerala 			[193]
Thiruvarur Junction 	TVR 	Tamil Nadu 			
Tiruvallur 	TRL 	Tamil Nadu 	SR/Southern 	47.46 m 	
Thivim 	THVM 	Goa 			
Thokur 	TOK 	Karnataka 			
Thuria, India 	THUR 				
Tibi 	TIBI 	Rajasthan 			
Tihu 	TIHU 	Assam 	NFR/Northeast Frontier 	46 m 	[194]
Tikaria 	TKYR 				
Tikekarwadi 	TKKD 				
Tikunia 	TQN 				
Tilak Bridge 	TKJ 	Delhi 			
Tilak Nagar 		Maharashtra 	Harbour (CR)
Tilaru 	TIU 	Andhra Pradesh 			
Tilaiya 	TIA 	Bihar 			
Tilda 	TLD 	Chhattisgarh 			
Tilhar 	TLH 				
Tilrath 	TIL 				
Tilwara 	TWL 				
Timarni 	TBN 	Madhya Pradesh 			
Timba Road 	TBA 				
Timmapur 	TMX 	Andhra Pradesh 			
Tinai Ghat 	TGT 				
Tindivanam 	TMV 	Tamil Nadu 			
Tinpahar Junction 	TPH 	Jharkhand 			
Tinsukia Junction 	TSK 	Assam 			
Tipkai 	TPK 	Assam 	NFR/Northeast Frontier 	43 m 	[195]
Tipling 	TPG 				
Tiptur 	TTR 				
Tiruchirapalli Fort 	TP 	Tamil Nadu 			
Tirodi 	TRDI 				
Tirora 	TRO 	Maharashtra 			
Tiruchirapalli 	TPJ 	Tamil Nadu 	SR/Southern Railway 	85m 	[196]
Tiruchendur 	TCN 	Tamil Nadu 	SR/Southern Railway 	5m 	[197]
Tiruchirapalli PLKI 	TPE 	Tamil Nadu 			
Tirukoilur 	TRK 	Tamil Nadu 			
Tirumangalam 	TMQ 	Tamil Nadu 			
Tirumalai Hills OA 	TTH 				
Tirunagesvaram 	TRM 	Tamil Nadu 			
Tirunelveli Junction 	TEN 	Tamil Nadu 	SR/Southern Railway 	45m 	[198]
Tirupadripuliyur 	TDPR 	Tamil Nadu 			
Tirupati 	TPTY 	Andhra Pradesh 			
Tirupattur Junction 	TPT 	Tamil Nadu 			
Tiruppappuliyur 	CUD 	Tamil Nadu 			
Tiruppur 	TUP 	Tamil Nadu 			
Tirur 	TIR 	Kerala 			
Tiruttani 	TRT 	Tamil Nadu 			
Tiruttangal 	TTL 	Tamil Nadu 	SR/Southern 	90 m 	[199]
Tiruturaipundi Junction 	TTP 	Tamil Nadu 			
Tiruvalla 	TRVL 	Kerala 			
Tiruvangur 	TVF 				
Tiruvannamalai 	TNM 	Tamil Nadu 			
Tiruverumbur 	TRB 	Tamil Nadu 			
Tiruvidaimarudur 	TDR 	Tamil Nadu 			
Tiruvottiyur 	TVT 	Tamil Nadu 	SR/Southern 	7 m 	
Tisi 	TISI 				
Tisua 	TSA 				
Titabar 	TTB 				
Titagarh 	TGH 	West Bengal 			
Titlagarh Junction 	TIG 	Odisha 	ECoR/East Coast 		
Titwala 	TL 	Maharashtra 	CR/Central
Tivari 	TIW 				
Toda Rai Singh 	TDRS 				
Todarpur 	TDP 				
Tohana 	TUN 				
Toranagallu 	TNGL 	Andhra Pradesh 			
Tori 	TORI 	Jharkhand 			
Trichur 	TCR 	Kerala 			
Trikarpur 	TKQ 	Kerala 			
Trilochan Mahdo 	TLMD 				
Tripunittura 	TRTR 	Kerala 			
Tondiarpet 	TNP 	Tamil Nadu 	SR/Southern 	5 m 	
Tsunduru 	TSR 				
Tughlakabad 	TKD 	Delhi 			
Tukaithad 	TTZ 				
Tulsipur 	TLR 				
Tulwara Jhil 	TLI 				
Tumkur 	TK 	Karnataka 			
Tumsar Road 	TMR 	Maharashtra 			
Tundla Junction 	TDL 	Uttar Pradesh 			
Tuni 	TUNI 	Andhra Pradesh 			
Turbhe 	TUH 	Maharashtra 	Trans-Harbour (CR)
Turtipar 	TTI 				
Tuti Melur 	TME 				
Tuticorin 	TN 	Tamil Nadu 			
Tuwa 	TUWA 				
Twining Ganj 	TWG 				
Tyada 	TXD 	Andhra Pradesh 			
U
Station Name 	Station Code 	State 	Railway Zone 	Elevation 	Map
Uchana 	UCA 	Haryana 	
Udhampur 	UDH 	Jammu & Kashmir 	
Udaipur City 	UDZ 	Rajasthan 	
Udalguri 	ULG 	Assam 	
Udalkachar 	UKR 		
Udasar 	UDS 	Rajasthan 	
Udgir 	UDGR 	Maharashtra 	
Udhna Junction 	UDN 	Gujarat 	
Udramsar 	UMS 		
Udupi 	UD 	Karnataka 	Konkan Railway 	
Udvada 	UVD 	Gujarat 	
Ugar Khurd 	UGR 	Karnataka 	
Ugrasenpur 	URPR 		
Ugwe 	UGWE 		
Ujhani 	UJH 	Uttar Pradesh 	
Ujiarpur 	UJP 	Bihar 	
Ujjain Junction 	UJN 	Madhya Pradesh 	
Ukai Songadh 	USD 		
Ukshi 	UKC 	Maharashtra 	
Ulavapadu 	UPD 	Andhra Pradesh 	
Ulhasnagar 	ULNR 	Maharashtra 	CR/Central
Ullal 	ULL 	Karnataka 	
Umar Tali 	UTA 		
Umaria 	UMR 	Madhya Pradesh 	
Umbargam Road 	UBR 	Gujarat 	
Umed 	UMED 	Maharashtra 	
Umra 	UMRA 		
Umreth 	UMH 	Gujarat 	
Umri Maharashtra 	UMRI 	Maharashtra 	
Umroli 	UOI 	Maharashtra 	WR/Western
Una 	UNA 	Gujarat 	
Una Himachal 	UHL 	Himachal Pradesh 	
Unai Vansada Rd 	UNI 		
Unchahar Junction 	UCR 	Uttar Pradesh 	
Unchaulia 	UCH 		
Unchdih 	UND 		
Unchhera 	UHR 		
Unchi Bassi 	UCB 		
Undasa Madhawpu 	UDM 	Madhya Pradesh 	
Unhel 	UNL 	Madhya Pradesh 	
Unjalur 	URL 	Tamil Nadu 	
Unjha 	UJA 	Gujarat 	
Unkal 	UNK 		
Unnao Junction 	ON 	Uttar Pradesh 	
Uplai 	UPI 		
Upleta 	UA 	Gujarat 	
Uppal 	OPL 	Telangana 	
Uppalavai 	UPW 		
Urdauli 	UDX 		
Uruli Kanchan 	URI 	Maharashtra 	
Usmanpur 	UPR 		
Utarlai 	UTL 		
Utarsanda 	UTD 		
Utrahtia 	UTR 		
Uttarkathani 	UKE 		
Uttarpara 	UPA 	West Bengal 	
Uttukuli 	UKL 	Tamil Nadu 	
Udumalpettai 	UDT 	Tamil Nadu 	
V
Station Name 	Station Code 	State 	Railway Zone 	Elevation 	Map
Vadal 	VAL 		
Vadali 	VAE 	Andhra Pradesh 	
Vadgaon 	VDN 	Maharashtra 	
Vadiya Devli 	VDV 		
Vadnagar 	VDG 	Gujarat 	
Vadod 	VXD 		
Vadodara Junction 	BRC 	Gujarat 	WR/Western
Vadtal Swaminarayan 	VTL 	Gujarat 	
Vadviyala 	VVL 		
Vaghli 	VGL 		
Vaibhavwadi Rd 	VBW 	Maharashtra 	
Vaikom 	VARD 	Kerala 	SR/Southern
Vaitarna 	VTN 	Maharashtra 	WR/Western
Vaitheeswarankoil 	VDL 	Tamil Nadu 	
Valadar 	VLDR 		
Valivade 	VV 	Maharashtra 	
Vallabh Vidyanagar 	VLYN 	Gujarat 	
Vallikkunnu 	VLI 	Kerala 	
Valliyur 	VLY 	Tamil Nadu 	
Valsad 	BL 	Gujarat 	
Vedchha 	VDH 	Gujarat 	
Vambori 	VBR 		
Vangaon 	VGN 	Maharashtra 	WR/Western
Vangal 	VGL 	Tamil Nadu 	
Vangani 		Maharashtra 	CR/Central
Vaniyambadi 	VN 	Tamil Nadu 	SR/Southern
Vapi 	VAPI 	Gujarat 	WR/Western
Varahi 	VRX 		
Varanasi City 	BCY 	Uttar Pradesh 	
Varanasi Junction 	BSB 	Uttar Pradesh 	
Varangaon 	VNA 	Maharashtra 	
Varkala Sivagiri Station 	VAK 	Kerala 	
Vartej 	VTJ 	Gujarat 	
Vasad Junction 	VDA 		
Vasai Road 	BS 	Maharashtra 	WR/Western/CR/Central
Vasco da Gama 	VSG 	Goa 	
Vashi 	V 	Maharashtra 	Harbour/Trans-Harbour (CR)
Vasind 	VSD 	Maharashtra 	CR/Central
Vatva 	VTA 		
Vavdi 	VVD 		
Vavdi Road 	VVF 		
Vavera 	VVV 		
Vayalpad 	VLD 		
Veer 	VEER 	Maharashtra 	KR / Konkan Railway 	6 m 	[200]
Vellore Cantonment 	VLR 	Tamil Nadu 	
Vellore Town 	VT 	Tamil Nadu 	
Veraval 	VRL 	Gujarat 	
Verka Junction 	VKA 	Punjab 	
Verna 	VEN 	Goa 	
Vetapalemu 	VTM 	Andhra Pradesh 	
Vidisha 	BHS 	Madhya Pradesh 	
Vidyasagar 	VDS 		
Vidyavihar 	VVH 	Maharashtra 	CR/Central
Vijapur 	VJF 	Gujarat 	
Vijayawada Junction 	BZA 	Andhra Pradesh 	SCR/South Central Railway 		[201]
Vijaypur Jammu 	VJPJ 	Jammu and Kashmir 	
Vijpadi Road 	VJD 		
Vikarabad Junction 	VKB 	Telangana 	
Vikhroli 		Maharashtra 	CR/Central
Vikramgarh Alot 	VMA 		
Vikramnagar 	VRG 	Madhya Pradesh 	
Vilad 	VL 		
Vilavade 	VID 		
Vile Parle 	VLP 	Maharashtra 	WR/Western/Harbour (CR)
Villivakkam 	VLK 	Tamil Nadu 	SR/Southern 	10.25 m 	
Villupuram Junction 	VM 	Tamil Nadu 	
Vindhyachal 	BDL 	Uttar Pradesh 	
Vinukonda 	VKD 	Andhra Pradesh 	
Viramgam Junction 	VG 	Gujarat 	
Virar 	VR 	Maharashtra 	WR/Western
Virarakkiyam 	VRQ 		
Virbhadra 	VRH 		
Virdel Road 	VRD 		
Virpur 	VRR 	Gujarat 	
Virudunagar Junction 	VPT 	Tamil Nadu 	
Visapur 	VPR 	Maharashtra 	
Visavadar 	VSW 	Gujarat 	
Visakhapatnam Junction 	VSKP 	Andhra Pradesh 	
Vishvamitri 	VS 	Gujarat 	
Visnagar 	VNG 	Gujarat 	
Viswanath Chrli 	VNE 		
Vithalwadi 		Maharashtra 	CR/Central
Viveka Vihar 	VVB 		
Vizianagaram Junction 	VZM 	Andhra Pradesh 	
V. O. C. Nagar 	VOC 	Tamil Nadu 	SR/Southern 	5 m 	
Vondh 	VON 		
Vriddhachalam Junction 	VRI 	Tamil nadu 	
Vrindavan 	BDB 	Uttar Pradesh 	
Vyara 	VYA 	Gujarat 	
Vyasarpadi Jeeva 	VJM 	Tamil Nadu 	SR/Southern 	5 m 	
Vyasnagar 	VYN 		
W
Station Name 	Station Code 	State 	Railway Zone 	Elevation 	Map
Wadakanchery 	WKI 	Kerala 	
Wadala Road 		Maharashtra 	Harbour (CR)
Wadhwan City 	WC 	Gujarat 	
Wadi Junction 	WADI 	Karnataka 	
Wadiaram 	WDR 		
Waghoda 	WGA 		
Wadoda 	WDD 	Maharashtra 	
Wadrengdisa 	WDA 	Assam 	NFR/Northeast Frontier 	352 m 	[202]
Wair 	WAIR 	Rajasthan 	
Walajah Road Junction 	WJR 	Tamil Nadu
Waltair 	WAT 	Andhra Pradesh 	
Wan Road 	WND 	Maharashtra 	
Wankaner Junction 	WKR 	Gujarat 	
Wanparti Road 	WPR 	Telangana 	
Wansjaliya 	WSJ 		
Warangal 	WL 	Telangana 	
Wardha East 	WRE 	Maharashtra 	
Wardha Junction 	WR 	Maharashtra 	
Waria 	OYR 	West Bengal 	
Waris Aleganj 	WRS 	Uttar Pradesh 	
Warora 	WRR 	Maharashtra 	
Washim 	WHM 	Maharashtra 	
Wathar 	WTR 	Maharashtra 	
Wellington 	WEL 	Tamil Nadu 	
West Mambalam 	MBM 	Tamil Nadu
Wena 	WENA 		
Whitefield 	WFD 	Karnataka 	
Wimco Nagar 	WCN 	Tamil Nadu 	SR/Southern 	9 m 	
Wyndhamganj 	WDM 	Uttar Pradesh 	
Y
Station Name 	Station Code 	State 	Railway Zone 	Elevation 	Map
Yadgir 	YG 	Karnataka 	
Yamuna 	JAB 	Uttar Pradesh 	
Yavatmal Terminus 	YTL 	Maharashtra 	
Yedakumeri 	YDK 	Karnataka 	
Yelahanka Junction 	YNK 	Karnataka 	
Yeliyur 	Y 		
Yeola 	YL 	Maharashtra 	
Yerraguntla 	YA 	Andhra Pradesh 	
Yesvantpur Junction 	YPR 	Karnataka 	
Yevat 	YT 		
Yusufpur 	YFP 	Uttar Pradesh 	
Z
Station Name 	Station Code 	State 	Railway Zone 	Elevation 	Map
Zafarabad Junction 	ZBD 	Uttar Pradesh 	
Zahirabad 	ZB 	Telangana 	
Zamania 	ZNA 	Uttar Pradesh 	
Zampini 	ZPI 	Andhra Pradesh 	
Zawar 	ZW 	Rajasthan 	

zankhvav znk [Gujarat]